Fold,Epoch,Loss,Accuracy,Pred_Real,Pred_Fake,True_Real,True_Fake,TN,FP,FN,TP
1,0,0.7010394930839539,0.4140625,128,0,53,75,53,0,75,0
1,1,1.94668710231781,0.5859375,0,128,53,75,0,53,0,75
1,2,0.34924155473709106,0.5859375,0,128,53,75,0,53,0,75
1,3,0.7065222263336182,0.5859375,0,128,53,75,0,53,0,75
1,4,0.2409559190273285,0.5859375,0,128,53,75,0,53,0,75
1,5,0.21342580020427704,0.5859375,0,128,53,75,0,53,0,75
1,6,0.23803454637527466,0.5859375,0,128,53,75,0,53,0,75
1,7,0.23555566370487213,0.5859375,0,128,53,75,0,53,0,75
1,8,0.21199160814285278,0.5859375,0,128,53,75,0,53,0,75
1,9,0.19315674901008606,0.5859375,0,128,53,75,0,53,0,75
1,10,0.1792590171098709,0.5859375,0,128,53,75,0,53,0,75
1,11,0.16810104250907898,0.5859375,0,128,53,75,0,53,0,75
1,12,0.15384440124034882,0.5859375,0,128,53,75,0,53,0,75
1,13,0.1377137303352356,0.5859375,0,128,53,75,0,53,0,75
1,14,0.12024243921041489,0.5859375,0,128,53,75,0,53,0,75
1,15,0.10433480888605118,0.5859375,0,128,53,75,0,53,0,75
1,16,0.08982691913843155,0.5859375,0,128,53,75,0,53,0,75
1,17,0.07965674251317978,0.5859375,0,128,53,75,0,53,0,75
1,18,0.07135674357414246,0.6015625,2,126,53,75,2,51,0,75
1,19,0.06431113183498383,0.609375,3,125,53,75,3,50,0,75
1,20,0.057248786091804504,0.6171875,4,124,53,75,4,49,0,75
1,21,0.050114888697862625,0.6328125,6,122,53,75,6,47,0,75
1,22,0.04371217265725136,0.6640625,10,118,53,75,10,43,0,75
1,23,0.03846340253949165,0.6640625,16,112,53,75,13,40,3,72
1,24,0.0353749543428421,0.65625,17,111,53,75,13,40,4,71
1,25,0.032122764736413956,0.6640625,18,110,53,75,14,39,4,71
1,26,0.029488572850823402,0.703125,23,105,53,75,19,34,4,71
1,27,0.0264427550137043,0.7109375,26,102,53,75,21,32,5,70
1,28,0.02455148659646511,0.7265625,30,98,53,75,24,29,6,69
1,29,0.022668633610010147,0.71875,35,93,53,75,26,27,9,66
1,30,0.02055511437356472,0.7109375,38,90,53,75,27,26,11,64
1,31,0.018580520525574684,0.71875,39,89,53,75,28,25,11,64
1,32,0.017162302508950233,0.7109375,42,86,53,75,29,24,13,62
1,33,0.01609409973025322,0.71875,45,83,53,75,31,22,14,61
1,34,0.014865444041788578,0.71875,49,79,53,75,33,20,16,59
1,35,0.013918672688305378,0.7265625,50,78,53,75,34,19,16,59
1,36,0.013003461062908173,0.7265625,50,78,53,75,34,19,16,59
1,37,0.012579992413520813,0.734375,51,77,53,75,35,18,16,59
1,38,0.011469647288322449,0.7421875,54,74,53,75,37,16,17,58
1,39,0.010898411273956299,0.7421875,54,74,53,75,37,16,17,58
1,40,0.01047099381685257,0.75,55,73,53,75,38,15,17,58
1,41,0.01003996841609478,0.7421875,56,72,53,75,38,15,18,57
1,42,0.010122029110789299,0.7421875,56,72,53,75,38,15,18,57
1,43,0.009110908024013042,0.75,57,71,53,75,39,14,18,57
1,44,0.008546515367925167,0.7578125,58,70,53,75,40,13,18,57
1,45,0.008311592042446136,0.7578125,58,70,53,75,40,13,18,57
1,46,0.008229250088334084,0.7578125,58,70,53,75,40,13,18,57
1,47,0.007701188791543245,0.7578125,58,70,53,75,40,13,18,57
1,48,0.007374738343060017,0.7578125,58,70,53,75,40,13,18,57
1,49,0.007399324793368578,0.75,57,71,53,75,39,14,18,57
2,0,0.7107941508293152,0.5905511811023622,0,127,52,75,0,52,0,75
2,1,2.0320053100585938,0.4094488188976378,127,0,52,75,52,0,75,0
2,2,0.3534137010574341,0.4094488188976378,127,0,52,75,52,0,75,0
2,3,0.6813956499099731,0.4094488188976378,127,0,52,75,52,0,75,0
2,4,0.29902011156082153,0.4094488188976378,127,0,52,75,52,0,75,0
2,5,0.23285673558712006,0.4094488188976378,127,0,52,75,52,0,75,0
2,6,0.26101863384246826,0.4094488188976378,127,0,52,75,52,0,75,0
2,7,0.2632012367248535,0.4094488188976378,127,0,52,75,52,0,75,0
2,8,0.24602314829826355,0.4094488188976378,127,0,52,75,52,0,75,0
2,9,0.2234748899936676,0.4094488188976378,127,0,52,75,52,0,75,0
2,10,0.203640878200531,0.4094488188976378,127,0,52,75,52,0,75,0
2,11,0.18486516177654266,0.4094488188976378,127,0,52,75,52,0,75,0
2,12,0.16692276298999786,0.4094488188976378,127,0,52,75,52,0,75,0
2,13,0.14923223853111267,0.4094488188976378,127,0,52,75,52,0,75,0
2,14,0.13086842000484467,0.4094488188976378,127,0,52,75,52,0,75,0
2,15,0.11381585150957108,0.4094488188976378,127,0,52,75,52,0,75,0
2,16,0.09858357161283493,0.41732283464566927,126,1,52,75,52,0,74,1
2,17,0.08609818667173386,0.4251968503937008,125,2,52,75,52,0,73,2
2,18,0.07660797983407974,0.48031496062992124,118,9,52,75,52,0,66,9
2,19,0.06802055239677429,0.5039370078740157,115,12,52,75,52,0,63,12
2,20,0.06105021387338638,0.5275590551181102,112,15,52,75,52,0,60,15
2,21,0.0530255101621151,0.5748031496062992,104,23,52,75,51,1,53,22
2,22,0.04675804451107979,0.6062992125984252,98,29,52,75,50,2,48,27
2,23,0.041970882564783096,0.6377952755905512,94,33,52,75,50,2,44,31
2,24,0.03642410412430763,0.6692913385826772,88,39,52,75,49,3,39,36
2,25,0.032538317143917084,0.6771653543307087,87,40,52,75,49,3,38,37
2,26,0.029233675450086594,0.6850393700787402,86,41,52,75,49,3,37,38
2,27,0.02682465873658657,0.7086614173228346,81,46,52,75,48,4,33,42
2,28,0.024091608822345734,0.6929133858267716,75,52,52,75,44,8,31,44
2,29,0.022653289139270782,0.7165354330708661,70,57,52,75,43,9,27,48
2,30,0.019531307741999626,0.7322834645669292,66,61,52,75,42,10,24,51
2,31,0.01803351193666458,0.7716535433070866,61,66,52,75,42,10,19,56
2,32,0.016342055052518845,0.7874015748031497,55,72,52,75,40,12,15,60
2,33,0.015149668790400028,0.7952755905511811,52,75,52,75,39,13,13,62
2,34,0.013993801549077034,0.8031496062992126,51,76,52,75,39,13,12,63
2,35,0.012988797388970852,0.8031496062992126,51,76,52,75,39,13,12,63
2,36,0.012089702300727367,0.8110236220472441,50,77,52,75,39,13,11,64
2,37,0.011168478056788445,0.8110236220472441,50,77,52,75,39,13,11,64
2,38,0.010557725094258785,0.8110236220472441,50,77,52,75,39,13,11,64
2,39,0.010206383652985096,0.8110236220472441,50,77,52,75,39,13,11,64
2,40,0.009364858269691467,0.8110236220472441,48,79,52,75,38,14,10,65
2,41,0.008722144179046154,0.7952755905511811,46,81,52,75,36,16,10,65
2,42,0.008424936793744564,0.7874015748031497,47,80,52,75,36,16,11,64
2,43,0.007643108256161213,0.7874015748031497,47,80,52,75,36,16,11,64
2,44,0.007618391886353493,0.7874015748031497,47,80,52,75,36,16,11,64
2,45,0.007156881969422102,0.7874015748031497,47,80,52,75,36,16,11,64
2,46,0.0066329557448625565,0.7874015748031497,47,80,52,75,36,16,11,64
2,47,0.006622661836445332,0.7795275590551181,46,81,52,75,35,17,11,64
2,48,0.006172557827085257,0.7795275590551181,46,81,52,75,35,17,11,64
2,49,0.006255778484046459,0.7795275590551181,46,81,52,75,35,17,11,64
3,0,0.7056565880775452,0.4094488188976378,127,0,52,75,52,0,75,0
3,1,1.9495664834976196,0.5905511811023622,0,127,52,75,0,52,0,75
3,2,0.3682447373867035,0.5905511811023622,0,127,52,75,0,52,0,75
3,3,0.8375383615493774,0.5905511811023622,0,127,52,75,0,52,0,75
3,4,0.30730560421943665,0.5905511811023622,0,127,52,75,0,52,0,75
3,5,0.22080440819263458,0.5905511811023622,0,127,52,75,0,52,0,75
3,6,0.2532254755496979,0.5905511811023622,0,127,52,75,0,52,0,75
3,7,0.26350295543670654,0.5905511811023622,0,127,52,75,0,52,0,75
3,8,0.2491902858018875,0.5905511811023622,0,127,52,75,0,52,0,75
3,9,0.22145025432109833,0.5905511811023622,0,127,52,75,0,52,0,75
3,10,0.19902303814888,0.5905511811023622,0,127,52,75,0,52,0,75
3,11,0.18306180834770203,0.5905511811023622,0,127,52,75,0,52,0,75
3,12,0.1693239063024521,0.5905511811023622,0,127,52,75,0,52,0,75
3,13,0.15517088770866394,0.5905511811023622,0,127,52,75,0,52,0,75
3,14,0.13703569769859314,0.5905511811023622,0,127,52,75,0,52,0,75
3,15,0.12066049873828888,0.5905511811023622,0,127,52,75,0,52,0,75
3,16,0.10443686693906784,0.5905511811023622,0,127,52,75,0,52,0,75
3,17,0.09055253863334656,0.5905511811023622,0,127,52,75,0,52,0,75
3,18,0.07912154495716095,0.5905511811023622,0,127,52,75,0,52,0,75
3,19,0.07099023461341858,0.5905511811023622,0,127,52,75,0,52,0,75
3,20,0.06300487369298935,0.5905511811023622,0,127,52,75,0,52,0,75
3,21,0.0555303581058979,0.5984251968503937,1,126,52,75,1,51,0,75
3,22,0.05024854838848114,0.6062992125984252,2,125,52,75,2,50,0,75
3,23,0.043420348316431046,0.6141732283464567,3,124,52,75,3,49,0,75
3,24,0.03870446979999542,0.6220472440944882,6,121,52,75,5,47,1,74
3,25,0.033475492149591446,0.6850393700787402,14,113,52,75,13,39,1,74
3,26,0.029894720762968063,0.7007874015748031,16,111,52,75,15,37,1,74
3,27,0.026692833751440048,0.7165354330708661,20,107,52,75,18,34,2,73
3,28,0.02350534312427044,0.7401574803149606,23,104,52,75,21,31,2,73
3,29,0.0220835879445076,0.7637795275590551,26,101,52,75,24,28,2,73
3,30,0.02057057060301304,0.7874015748031497,29,98,52,75,27,25,2,73
3,31,0.018551969900727272,0.8110236220472441,32,95,52,75,30,22,2,73
3,32,0.01643001288175583,0.84251968503937,36,91,52,75,34,18,2,73
3,33,0.015214799903333187,0.8503937007874016,39,88,52,75,36,16,3,72
3,34,0.013686900958418846,0.8661417322834646,41,86,52,75,38,14,3,72
3,35,0.012646831572055817,0.8818897637795275,45,82,52,75,41,11,4,71
3,36,0.011655976995825768,0.8818897637795275,49,78,52,75,43,9,6,69
3,37,0.01072619017213583,0.8740157480314961,50,77,52,75,43,9,7,68
3,38,0.009671029634773731,0.8740157480314961,52,75,52,75,44,8,8,67
3,39,0.009471827186644077,0.8740157480314961,54,73,52,75,45,7,9,66
3,40,0.0087148891761899,0.8661417322834646,55,72,52,75,45,7,10,65
3,41,0.008167336694896221,0.8661417322834646,55,72,52,75,45,7,10,65
3,42,0.007615759037435055,0.8661417322834646,55,72,52,75,45,7,10,65
3,43,0.007438010536134243,0.8661417322834646,55,72,52,75,45,7,10,65
3,44,0.007273300550878048,0.8661417322834646,55,72,52,75,45,7,10,65
3,45,0.006618445739150047,0.8661417322834646,55,72,52,75,45,7,10,65
3,46,0.006506090518087149,0.8661417322834646,55,72,52,75,45,7,10,65
3,47,0.005998613778501749,0.8661417322834646,55,72,52,75,45,7,10,65
3,48,0.006088019348680973,0.8661417322834646,55,72,52,75,45,7,10,65
3,49,0.005866650026291609,0.8661417322834646,55,72,52,75,45,7,10,65
4,0,0.7405500411987305,0.4094488188976378,127,0,52,75,52,0,75,0
4,1,1.9958587884902954,0.5905511811023622,0,127,52,75,0,52,0,75
4,2,0.5489418506622314,0.5905511811023622,0,127,52,75,0,52,0,75
4,3,0.5679433941841125,0.5905511811023622,0,127,52,75,0,52,0,75
4,4,0.35555168986320496,0.5905511811023622,0,127,52,75,0,52,0,75
4,5,0.2712930142879486,0.5905511811023622,0,127,52,75,0,52,0,75
4,6,0.26384252309799194,0.5905511811023622,0,127,52,75,0,52,0,75
4,7,0.26428526639938354,0.5905511811023622,0,127,52,75,0,52,0,75
4,8,0.2531783878803253,0.5905511811023622,0,127,52,75,0,52,0,75
4,9,0.232333704829216,0.5905511811023622,0,127,52,75,0,52,0,75
4,10,0.2093653380870819,0.5905511811023622,0,127,52,75,0,52,0,75
4,11,0.18686631321907043,0.5905511811023622,0,127,52,75,0,52,0,75
4,12,0.16626735031604767,0.5905511811023622,0,127,52,75,0,52,0,75
4,13,0.14888152480125427,0.5905511811023622,0,127,52,75,0,52,0,75
4,14,0.13276664912700653,0.5905511811023622,0,127,52,75,0,52,0,75
4,15,0.11806653439998627,0.5905511811023622,0,127,52,75,0,52,0,75
4,16,0.10367976129055023,0.5905511811023622,0,127,52,75,0,52,0,75
4,17,0.09107880294322968,0.5905511811023622,0,127,52,75,0,52,0,75
4,18,0.07915505021810532,0.5905511811023622,0,127,52,75,0,52,0,75
4,19,0.07018586993217468,0.5905511811023622,0,127,52,75,0,52,0,75
4,20,0.06196637451648712,0.6062992125984252,2,125,52,75,2,50,0,75
4,21,0.05531548336148262,0.6062992125984252,2,125,52,75,2,50,0,75
4,22,0.050051163882017136,0.6141732283464567,3,124,52,75,3,49,0,75
4,23,0.04343271255493164,0.6062992125984252,4,123,52,75,3,49,1,74
4,24,0.038801223039627075,0.6299212598425197,7,120,52,75,6,46,1,74
4,25,0.03412873297929764,0.6299212598425197,9,118,52,75,7,45,2,73
4,26,0.030754005536437035,0.6535433070866141,14,113,52,75,11,41,3,72
4,27,0.027570437639951706,0.6535433070866141,16,111,52,75,12,40,4,71
4,28,0.024790490046143532,0.6692913385826772,18,109,52,75,14,38,4,71
4,29,0.022440381348133087,0.6771653543307087,19,108,52,75,15,37,4,71
4,30,0.021010415628552437,0.6929133858267716,21,106,52,75,17,35,4,71
4,31,0.018813764676451683,0.7086614173228346,23,104,52,75,19,33,4,71
4,32,0.017600031569600105,0.7244094488188977,25,102,52,75,21,31,4,71
4,33,0.01608176901936531,0.7401574803149606,27,100,52,75,23,29,4,71
4,34,0.01480174157768488,0.7637795275590551,32,95,52,75,27,25,5,70
4,35,0.013784191571176052,0.7716535433070866,33,94,52,75,28,24,5,70
4,36,0.013023657724261284,0.7637795275590551,34,93,52,75,28,24,6,69
4,37,0.012277866713702679,0.7716535433070866,37,90,52,75,30,22,7,68
4,38,0.011731337755918503,0.7637795275590551,40,87,52,75,31,21,9,66
4,39,0.011075870133936405,0.7716535433070866,41,86,52,75,32,20,9,66
4,40,0.01122219953685999,0.7716535433070866,41,86,52,75,32,20,9,66
4,41,0.010184708051383495,0.7795275590551181,44,83,52,75,34,18,10,65
4,42,0.009376328438520432,0.7874015748031497,47,80,52,75,36,16,11,64
4,43,0.009120437316596508,0.7874015748031497,47,80,52,75,36,16,11,64
4,44,0.008721230551600456,0.7952755905511811,48,79,52,75,37,15,11,64
4,45,0.008048689924180508,0.8031496062992126,49,78,52,75,38,14,11,64
4,46,0.007866314612329006,0.8031496062992126,49,78,52,75,38,14,11,64
4,47,0.007849246263504028,0.8031496062992126,49,78,52,75,38,14,11,64
4,48,0.00802851002663374,0.8031496062992126,49,78,52,75,38,14,11,64
4,49,0.0072276294231414795,0.8031496062992126,49,78,52,75,38,14,11,64
5,0,0.7270380854606628,0.4094488188976378,127,0,52,75,52,0,75,0
5,1,2.025847911834717,0.5905511811023622,0,127,52,75,0,52,0,75
5,2,0.4985574781894684,0.5905511811023622,0,127,52,75,0,52,0,75
5,3,0.7062439322471619,0.5905511811023622,0,127,52,75,0,52,0,75
5,4,0.33465704321861267,0.5905511811023622,0,127,52,75,0,52,0,75
5,5,0.2534450888633728,0.5905511811023622,0,127,52,75,0,52,0,75
5,6,0.26124173402786255,0.5905511811023622,0,127,52,75,0,52,0,75
5,7,0.2669123113155365,0.5905511811023622,0,127,52,75,0,52,0,75
5,8,0.2566157579421997,0.5905511811023622,0,127,52,75,0,52,0,75
5,9,0.23668064177036285,0.5905511811023622,0,127,52,75,0,52,0,75
5,10,0.21294021606445312,0.5905511811023622,0,127,52,75,0,52,0,75
5,11,0.19179144501686096,0.5905511811023622,0,127,52,75,0,52,0,75
5,12,0.17228014767169952,0.5905511811023622,0,127,52,75,0,52,0,75
5,13,0.156022846698761,0.5905511811023622,0,127,52,75,0,52,0,75
5,14,0.13978572189807892,0.5905511811023622,0,127,52,75,0,52,0,75
5,15,0.12318355590105057,0.5905511811023622,0,127,52,75,0,52,0,75
5,16,0.10714022070169449,0.5905511811023622,0,127,52,75,0,52,0,75
5,17,0.09313881397247314,0.5984251968503937,1,126,52,75,1,51,0,75
5,18,0.08181002736091614,0.5984251968503937,1,126,52,75,1,51,0,75
5,19,0.07132770121097565,0.5984251968503937,1,126,52,75,1,51,0,75
5,20,0.06363609433174133,0.5984251968503937,1,126,52,75,1,51,0,75
5,21,0.05622047930955887,0.6220472440944882,4,123,52,75,4,48,0,75
5,22,0.05004807561635971,0.6456692913385826,7,120,52,75,7,45,0,75
5,23,0.043534159660339355,0.6614173228346457,9,118,52,75,9,43,0,75
5,24,0.03820199519395828,0.6850393700787402,12,115,52,75,12,40,0,75
5,25,0.03416486456990242,0.6850393700787402,12,115,52,75,12,40,0,75
5,26,0.03006431646645069,0.6929133858267716,13,114,52,75,13,39,0,75
5,27,0.027307894080877304,0.7007874015748031,14,113,52,75,14,38,0,75
5,28,0.025056540966033936,0.7401574803149606,19,108,52,75,19,33,0,75
5,29,0.022582584992051125,0.7559055118110236,21,106,52,75,21,31,0,75
5,30,0.020279034972190857,0.7480314960629921,24,103,52,75,22,30,2,73
5,31,0.018280908465385437,0.7716535433070866,27,100,52,75,25,27,2,73
5,32,0.01691260002553463,0.7716535433070866,29,98,52,75,26,26,3,72
5,33,0.015234746970236301,0.7795275590551181,30,97,52,75,27,25,3,72
5,34,0.01390603557229042,0.7952755905511811,32,95,52,75,29,23,3,72
5,35,0.013006673194468021,0.7952755905511811,34,93,52,75,30,22,4,71
5,36,0.012298261746764183,0.7874015748031497,35,92,52,75,30,22,5,70
5,37,0.01114632561802864,0.7795275590551181,36,91,52,75,30,22,6,69
5,38,0.010702535510063171,0.7795275590551181,36,91,52,75,30,22,6,69
5,39,0.00984578300267458,0.8031496062992126,39,88,52,75,33,19,6,69
5,40,0.009329664520919323,0.8031496062992126,39,88,52,75,33,19,6,69
5,41,0.009179825894534588,0.8031496062992126,39,88,52,75,33,19,6,69
5,42,0.008493692614138126,0.7952755905511811,40,87,52,75,33,19,7,68
5,43,0.008130121044814587,0.8031496062992126,41,86,52,75,34,18,7,68
5,44,0.007874851115047932,0.7952755905511811,42,85,52,75,34,18,8,67
5,45,0.007031790446490049,0.7952755905511811,42,85,52,75,34,18,8,67
5,46,0.007073617074638605,0.7874015748031497,43,84,52,75,34,18,9,66
5,47,0.0065048555843532085,0.7874015748031497,43,84,52,75,34,18,9,66
5,48,0.006625635549426079,0.7874015748031497,43,84,52,75,34,18,9,66
5,49,0.006087592802941799,0.7874015748031497,43,84,52,75,34,18,9,66
6,0,0.7028318047523499,0.5905511811023622,0,127,52,75,0,52,0,75
6,1,2.014545440673828,0.4094488188976378,127,0,52,75,52,0,75,0
6,2,0.28355345129966736,0.4094488188976378,127,0,52,75,52,0,75,0
6,3,0.33259785175323486,0.4094488188976378,127,0,52,75,52,0,75,0
6,4,0.20513750612735748,0.4094488188976378,127,0,52,75,52,0,75,0
6,5,0.21159157156944275,0.4094488188976378,127,0,52,75,52,0,75,0
6,6,0.1949421763420105,0.4094488188976378,127,0,52,75,52,0,75,0
6,7,0.1785638928413391,0.4094488188976378,127,0,52,75,52,0,75,0
6,8,0.16959314048290253,0.4094488188976378,127,0,52,75,52,0,75,0
6,9,0.14993733167648315,0.4094488188976378,127,0,52,75,52,0,75,0
6,10,0.12474852800369263,0.41732283464566927,126,1,52,75,52,0,74,1
6,11,0.10498467832803726,0.44881889763779526,122,5,52,75,52,0,70,5
6,12,0.09125474095344543,0.5118110236220472,112,15,52,75,51,1,61,14
6,13,0.0793415829539299,0.5196850393700787,109,18,52,75,50,2,59,16
6,14,0.06709478050470352,0.5905511811023622,100,27,52,75,50,2,50,25
6,15,0.055777937173843384,0.6535433070866141,92,35,52,75,50,2,42,33
6,16,0.048133719712495804,0.7086614173228346,85,42,52,75,50,2,35,40
6,17,0.04254947230219841,0.7716535433070866,77,50,52,75,50,2,27,48
6,18,0.036148570477962494,0.8031496062992126,71,56,52,75,49,3,22,53
6,19,0.030953891575336456,0.8110236220472441,64,63,52,75,46,6,18,57
6,20,0.027647752314805984,0.8267716535433071,60,67,52,75,45,7,15,60
6,21,0.023870935663580894,0.8110236220472441,58,69,52,75,43,9,15,60
6,22,0.021314959973096848,0.7716535433070866,51,76,52,75,37,15,14,61
6,23,0.01937255635857582,0.7874015748031497,49,78,52,75,37,15,12,63
6,24,0.016752861440181732,0.8188976377952756,41,86,52,75,35,17,6,69
6,25,0.016023781150579453,0.8188976377952756,41,86,52,75,35,17,6,69
6,26,0.01480184681713581,0.8188976377952756,39,88,52,75,34,18,5,70
6,27,0.013063164427876472,0.8031496062992126,37,90,52,75,32,20,5,70
6,28,0.012139140628278255,0.7874015748031497,35,92,52,75,30,22,5,70
6,29,0.010715208016335964,0.7795275590551181,36,91,52,75,30,22,6,69
6,30,0.010252034291625023,0.7795275590551181,36,91,52,75,30,22,6,69
6,31,0.009641771204769611,0.7952755905511811,36,91,52,75,31,21,5,70
6,32,0.009101847186684608,0.7874015748031497,35,92,52,75,30,22,5,70
6,33,0.008802436292171478,0.7874015748031497,35,92,52,75,30,22,5,70
6,34,0.007778744678944349,0.7874015748031497,35,92,52,75,30,22,5,70
6,35,0.007560086902230978,0.7874015748031497,35,92,52,75,30,22,5,70
6,36,0.007197352591902018,0.7874015748031497,35,92,52,75,30,22,5,70
6,37,0.006871347315609455,0.7795275590551181,36,91,52,75,30,22,6,69
6,38,0.006831505335867405,0.7795275590551181,36,91,52,75,30,22,6,69
6,39,0.00677104014903307,0.7795275590551181,36,91,52,75,30,22,6,69
6,40,0.00634358637034893,0.7795275590551181,36,91,52,75,30,22,6,69
6,41,0.006059836130589247,0.7874015748031497,37,90,52,75,31,21,6,69
6,42,0.006603876128792763,0.7874015748031497,37,90,52,75,31,21,6,69
6,43,0.005525446962565184,0.7952755905511811,38,89,52,75,32,20,6,69
6,44,0.005623354576528072,0.7952755905511811,38,89,52,75,32,20,6,69
6,45,0.0056331888772547245,0.7952755905511811,38,89,52,75,32,20,6,69
6,46,0.0054268864914774895,0.8031496062992126,39,88,52,75,33,19,6,69
6,47,0.0054611461237072945,0.8031496062992126,41,86,52,75,34,18,7,68
6,48,0.005568552762269974,0.8110236220472441,42,85,52,75,35,17,7,68
6,49,0.004979927558451891,0.8188976377952756,43,84,52,75,36,16,7,68
7,0,0.7717481255531311,0.4094488188976378,127,0,52,75,52,0,75,0
7,1,1.911298394203186,0.5905511811023622,0,127,52,75,0,52,0,75
7,2,0.6234868168830872,0.5905511811023622,0,127,52,75,0,52,0,75
7,3,0.54664546251297,0.5905511811023622,0,127,52,75,0,52,0,75
7,4,0.3802778422832489,0.5905511811023622,0,127,52,75,0,52,0,75
7,5,0.3164016008377075,0.5905511811023622,0,127,52,75,0,52,0,75
7,6,0.3026061952114105,0.6535433070866141,8,119,52,75,8,44,0,75
7,7,0.2905326187610626,0.7244094488188977,29,98,52,75,23,29,6,69
7,8,0.2688470482826233,0.7244094488188977,25,102,52,75,21,31,4,71
7,9,0.24252478778362274,0.7007874015748031,16,111,52,75,15,37,1,74
7,10,0.21384264528751373,0.6614173228346457,9,118,52,75,9,43,0,75
7,11,0.18898238241672516,0.6299212598425197,5,122,52,75,5,47,0,75
7,12,0.16475540399551392,0.6220472440944882,4,123,52,75,4,48,0,75
7,13,0.1436983048915863,0.6062992125984252,2,125,52,75,2,50,0,75
7,14,0.12580260634422302,0.6062992125984252,2,125,52,75,2,50,0,75
7,15,0.10980818420648575,0.6062992125984252,2,125,52,75,2,50,0,75
7,16,0.09629573673009872,0.6141732283464567,3,124,52,75,3,49,0,75
7,17,0.08235275000333786,0.6141732283464567,3,124,52,75,3,49,0,75
7,18,0.07201364636421204,0.6141732283464567,3,124,52,75,3,49,0,75
7,19,0.06274625658988953,0.6141732283464567,5,122,52,75,4,48,1,74
7,20,0.055138424038887024,0.6220472440944882,6,121,52,75,5,47,1,74
7,21,0.04717128723859787,0.6220472440944882,6,121,52,75,5,47,1,74
7,22,0.041926730424165726,0.6299212598425197,7,120,52,75,6,46,1,74
7,23,0.03677688539028168,0.6456692913385826,11,116,52,75,9,43,2,73
7,24,0.03193119540810585,0.6456692913385826,11,116,52,75,9,43,2,73
7,25,0.028679892420768738,0.6377952755905512,12,115,52,75,9,43,3,72
7,26,0.025338241830468178,0.6456692913385826,13,114,52,75,10,42,3,72
7,27,0.023456081748008728,0.6456692913385826,15,112,52,75,11,41,4,71
7,28,0.02065325900912285,0.6456692913385826,17,110,52,75,12,40,5,70
7,29,0.01908821053802967,0.6614173228346457,19,108,52,75,14,38,5,70
7,30,0.01728125661611557,0.6850393700787402,22,105,52,75,17,35,5,70
7,31,0.015541532076895237,0.7007874015748031,24,103,52,75,19,33,5,70
7,32,0.014444557949900627,0.7165354330708661,26,101,52,75,21,31,5,70
7,33,0.01296269427984953,0.7244094488188977,31,96,52,75,24,28,7,68
7,34,0.012066138908267021,0.7322834645669292,32,95,52,75,25,27,7,68
7,35,0.0115624088793993,0.7244094488188977,35,92,52,75,26,26,9,66
7,36,0.010739720426499844,0.7244094488188977,35,92,52,75,26,26,9,66
7,37,0.009959172457456589,0.7244094488188977,35,92,52,75,26,26,9,66
7,38,0.009814925491809845,0.7401574803149606,37,90,52,75,28,24,9,66
7,39,0.009060444310307503,0.7401574803149606,37,90,52,75,28,24,9,66
7,40,0.008491281419992447,0.7401574803149606,37,90,52,75,28,24,9,66
7,41,0.008087169378995895,0.7401574803149606,37,90,52,75,28,24,9,66
7,42,0.007691750768572092,0.7480314960629921,38,89,52,75,29,23,9,66
7,43,0.007564856670796871,0.7401574803149606,39,88,52,75,29,23,10,65
7,44,0.0072377342730760574,0.7401574803149606,39,88,52,75,29,23,10,65
7,45,0.006872248835861683,0.7480314960629921,40,87,52,75,30,22,10,65
7,46,0.0067253075540065765,0.7637795275590551,42,85,52,75,32,20,10,65
7,47,0.006346979644149542,0.7559055118110236,43,84,52,75,32,20,11,64
7,48,0.006638374179601669,0.7637795275590551,44,83,52,75,33,19,11,64
7,49,0.006294965744018555,0.7637795275590551,44,83,52,75,33,19,11,64
8,0,0.6939430236816406,0.4094488188976378,127,0,52,75,52,0,75,0
8,1,1.9047306776046753,0.5984251968503937,1,126,52,75,1,51,0,75
8,2,0.32087135314941406,0.5905511811023622,0,127,52,75,0,52,0,75
8,3,0.6692535877227783,0.5905511811023622,0,127,52,75,0,52,0,75
8,4,0.25670307874679565,0.5905511811023622,0,127,52,75,0,52,0,75
8,5,0.20308299362659454,0.5905511811023622,0,127,52,75,0,52,0,75
8,6,0.23411686718463898,0.5905511811023622,0,127,52,75,0,52,0,75
8,7,0.23773601651191711,0.5905511811023622,0,127,52,75,0,52,0,75
8,8,0.21490363776683807,0.5905511811023622,0,127,52,75,0,52,0,75
8,9,0.19118452072143555,0.5905511811023622,0,127,52,75,0,52,0,75
8,10,0.17389324307441711,0.5905511811023622,0,127,52,75,0,52,0,75
8,11,0.1615137755870819,0.5905511811023622,0,127,52,75,0,52,0,75
8,12,0.14906534552574158,0.5905511811023622,0,127,52,75,0,52,0,75
8,13,0.13411547243595123,0.5905511811023622,0,127,52,75,0,52,0,75
8,14,0.1154656782746315,0.5905511811023622,0,127,52,75,0,52,0,75
8,15,0.09891427308320999,0.5905511811023622,0,127,52,75,0,52,0,75
8,16,0.08405130356550217,0.6141732283464567,3,124,52,75,3,49,0,75
8,17,0.0733228474855423,0.6141732283464567,5,122,52,75,4,48,1,74
8,18,0.06571750342845917,0.6456692913385826,11,116,52,75,9,43,2,73
8,19,0.058643240481615067,0.6692913385826772,14,113,52,75,12,40,2,73
8,20,0.05324376001954079,0.6692913385826772,16,111,52,75,13,39,3,72
8,21,0.04658994823694229,0.7086614173228346,23,104,52,75,19,33,4,71
8,22,0.03995426744222641,0.7401574803149606,27,100,52,75,23,29,4,71
8,23,0.03529217094182968,0.7637795275590551,30,97,52,75,26,26,4,71
8,24,0.030577508732676506,0.7559055118110236,31,96,52,75,26,26,5,70
8,25,0.027747225016355515,0.7244094488188977,35,92,52,75,26,26,9,66
8,26,0.024873975664377213,0.7322834645669292,38,89,52,75,28,24,10,65
8,27,0.023150740191340446,0.7244094488188977,41,86,52,75,29,23,12,63
8,28,0.021282454952597618,0.7322834645669292,44,83,52,75,31,21,13,62
8,29,0.019100293517112732,0.7322834645669292,46,81,52,75,32,20,14,61
8,30,0.017139848321676254,0.7401574803149606,49,78,52,75,34,18,15,60
8,31,0.015843113884329796,0.7401574803149606,49,78,52,75,34,18,15,60
8,32,0.014655433595180511,0.7401574803149606,51,76,52,75,35,17,16,59
8,33,0.013552123680710793,0.7480314960629921,54,73,52,75,37,15,17,58
8,34,0.012318604625761509,0.7401574803149606,55,72,52,75,37,15,18,57
8,35,0.011478036642074585,0.7401574803149606,57,70,52,75,38,14,19,56
8,36,0.010876390151679516,0.7559055118110236,57,70,52,75,39,13,18,57
8,37,0.010425266809761524,0.7559055118110236,57,70,52,75,39,13,18,57
8,38,0.009623179212212563,0.7637795275590551,58,69,52,75,40,12,18,57
8,39,0.00903942622244358,0.7559055118110236,59,68,52,75,40,12,19,56
8,40,0.00867024902254343,0.7401574803149606,59,68,52,75,39,13,20,55
8,41,0.008310558274388313,0.7401574803149606,59,68,52,75,39,13,20,55
8,42,0.008281875401735306,0.7401574803149606,59,68,52,75,39,13,20,55
8,43,0.007729957811534405,0.7401574803149606,59,68,52,75,39,13,20,55
8,44,0.0071105933748185635,0.7559055118110236,57,70,52,75,39,13,18,57
8,45,0.0068348851054906845,0.7559055118110236,57,70,52,75,39,13,18,57
8,46,0.006633484736084938,0.7559055118110236,57,70,52,75,39,13,18,57
8,47,0.0063948798924684525,0.7480314960629921,56,71,52,75,38,14,18,57
8,48,0.006354833021759987,0.7559055118110236,55,72,52,75,38,14,17,58
8,49,0.0060036699287593365,0.7480314960629921,54,73,52,75,37,15,17,58
9,0,0.6927972435951233,0.4409448818897638,123,4,52,75,52,0,71,4
9,1,0.37596169114112854,0.4094488188976378,127,0,52,75,52,0,75,0
9,2,0.960536003112793,0.5984251968503937,1,126,52,75,1,51,0,75
9,3,0.1778024435043335,0.5905511811023622,0,127,52,75,0,52,0,75
9,4,0.3113552927970886,0.5984251968503937,1,126,52,75,1,51,0,75
9,5,0.17726342380046844,0.6220472440944882,4,123,52,75,4,48,0,75
9,6,0.11937877535820007,0.6141732283464567,3,124,52,75,3,49,0,75
9,7,0.1299174278974533,0.6141732283464567,3,124,52,75,3,49,0,75
9,8,0.12939275801181793,0.5905511811023622,0,127,52,75,0,52,0,75
9,9,0.11341332644224167,0.5905511811023622,0,127,52,75,0,52,0,75
9,10,0.08895757049322128,0.5905511811023622,0,127,52,75,0,52,0,75
9,11,0.0802452489733696,0.5905511811023622,0,127,52,75,0,52,0,75
9,12,0.07965442538261414,0.5905511811023622,0,127,52,75,0,52,0,75
9,13,0.07842602580785751,0.5905511811023622,0,127,52,75,0,52,0,75
9,14,0.06919461488723755,0.5905511811023622,0,127,52,75,0,52,0,75
9,15,0.05852038040757179,0.5905511811023622,0,127,52,75,0,52,0,75
9,16,0.049842678010463715,0.5905511811023622,0,127,52,75,0,52,0,75
9,17,0.04369525983929634,0.5905511811023622,0,127,52,75,0,52,0,75
9,18,0.04074735939502716,0.5905511811023622,0,127,52,75,0,52,0,75
9,19,0.03816869854927063,0.5984251968503937,1,126,52,75,1,51,0,75
9,20,0.03486194461584091,0.6062992125984252,2,125,52,75,2,50,0,75
9,21,0.03136993572115898,0.6062992125984252,2,125,52,75,2,50,0,75
9,22,0.028666513040661812,0.6141732283464567,3,124,52,75,3,49,0,75
9,23,0.024184880778193474,0.6141732283464567,3,124,52,75,3,49,0,75
9,24,0.022224504500627518,0.6141732283464567,3,124,52,75,3,49,0,75
9,25,0.020831694826483727,0.6141732283464567,3,124,52,75,3,49,0,75
9,26,0.018844924867153168,0.6141732283464567,3,124,52,75,3,49,0,75
9,27,0.01756439544260502,0.6299212598425197,7,120,52,75,6,46,1,74
9,28,0.016113268211483955,0.6220472440944882,10,117,52,75,7,45,3,72
9,29,0.015373935922980309,0.6220472440944882,14,113,52,75,9,43,5,70
9,30,0.014159146696329117,0.6692913385826772,20,107,52,75,15,37,5,70
9,31,0.013041002675890923,0.7086614173228346,27,100,52,75,21,31,6,69
9,32,0.012214931659400463,0.7480314960629921,32,95,52,75,26,26,6,69
9,33,0.011204993352293968,0.7559055118110236,33,94,52,75,27,25,6,69
9,34,0.01047024317085743,0.7637795275590551,40,87,52,75,31,21,9,66
9,35,0.00986478291451931,0.7637795275590551,42,85,52,75,32,20,10,65
9,36,0.009624301455914974,0.7795275590551181,48,79,52,75,36,16,12,63
9,37,0.009328407235443592,0.7637795275590551,50,77,52,75,36,16,14,61
9,38,0.008907521143555641,0.7874015748031497,53,74,52,75,39,13,14,61
9,39,0.008571401238441467,0.7874015748031497,53,74,52,75,39,13,14,61
9,40,0.008817763067781925,0.7795275590551181,54,73,52,75,39,13,15,60
9,41,0.007383185904473066,0.7716535433070866,55,72,52,75,39,13,16,59
9,42,0.0070524560287594795,0.7795275590551181,58,69,52,75,41,11,17,58
9,43,0.006873466540127993,0.7795275590551181,58,69,52,75,41,11,17,58
9,44,0.006660445127636194,0.7874015748031497,59,68,52,75,42,10,17,58
9,45,0.00632462976500392,0.7874015748031497,61,66,52,75,43,9,18,57
9,46,0.0068822018802165985,0.7874015748031497,61,66,52,75,43,9,18,57
9,47,0.006013969425112009,0.7795275590551181,60,67,52,75,42,10,18,57
9,48,0.006115797907114029,0.7716535433070866,61,66,52,75,42,10,19,56
9,49,0.00584029546007514,0.7716535433070866,61,66,52,75,42,10,19,56
10,0,0.6994485855102539,0.4094488188976378,127,0,52,75,52,0,75,0
10,1,1.838064432144165,0.5905511811023622,0,127,52,75,0,52,0,75
10,2,0.34187430143356323,0.5905511811023622,0,127,52,75,0,52,0,75
10,3,0.7116481065750122,0.5905511811023622,0,127,52,75,0,52,0,75
10,4,0.27494993805885315,0.5905511811023622,0,127,52,75,0,52,0,75
10,5,0.22215941548347473,0.5905511811023622,0,127,52,75,0,52,0,75
10,6,0.2539287209510803,0.5905511811023622,0,127,52,75,0,52,0,75
10,7,0.2528096139431,0.5905511811023622,0,127,52,75,0,52,0,75
10,8,0.22907008230686188,0.5905511811023622,0,127,52,75,0,52,0,75
10,9,0.20595873892307281,0.5905511811023622,0,127,52,75,0,52,0,75
10,10,0.1869487762451172,0.5905511811023622,0,127,52,75,0,52,0,75
10,11,0.1743984818458557,0.5905511811023622,0,127,52,75,0,52,0,75
10,12,0.16157303750514984,0.5905511811023622,0,127,52,75,0,52,0,75
10,13,0.14481189846992493,0.5905511811023622,0,127,52,75,0,52,0,75
10,14,0.12634043395519257,0.5905511811023622,0,127,52,75,0,52,0,75
10,15,0.10906198620796204,0.5905511811023622,0,127,52,75,0,52,0,75
10,16,0.09473305195569992,0.5905511811023622,0,127,52,75,0,52,0,75
10,17,0.08346512168645859,0.5905511811023622,0,127,52,75,0,52,0,75
10,18,0.07504623383283615,0.5905511811023622,0,127,52,75,0,52,0,75
10,19,0.0669349804520607,0.5984251968503937,1,126,52,75,1,51,0,75
10,20,0.05951131507754326,0.5984251968503937,1,126,52,75,1,51,0,75
10,21,0.05213027074933052,0.6141732283464567,3,124,52,75,3,49,0,75
10,22,0.046335842460393906,0.6299212598425197,5,122,52,75,5,47,0,75
10,23,0.04015069454908371,0.6377952755905512,6,121,52,75,6,46,0,75
10,24,0.035915374755859375,0.6456692913385826,7,120,52,75,7,45,0,75
10,25,0.03235701844096184,0.6535433070866141,8,119,52,75,8,44,0,75
10,26,0.02959461696445942,0.6614173228346457,9,118,52,75,9,43,0,75
10,27,0.026704415678977966,0.6850393700787402,14,113,52,75,13,39,1,74
10,28,0.0249564778059721,0.7165354330708661,18,109,52,75,17,35,1,74
10,29,0.022170256823301315,0.7244094488188977,19,108,52,75,18,34,1,74
10,30,0.019959131255745888,0.7401574803149606,25,102,52,75,22,30,3,72
10,31,0.018329298123717308,0.7637795275590551,28,99,52,75,25,27,3,72
10,32,0.017145605757832527,0.7795275590551181,32,95,52,75,28,24,4,71
10,33,0.015795322135090828,0.7795275590551181,38,89,52,75,31,21,7,68
10,34,0.014146396890282631,0.7874015748031497,39,88,52,75,32,20,7,68
10,35,0.013635965995490551,0.7874015748031497,41,86,52,75,33,19,8,67
10,36,0.012727308087050915,0.8031496062992126,47,80,52,75,37,15,10,65
10,37,0.011667071841657162,0.8110236220472441,48,79,52,75,38,14,10,65
10,38,0.011077668517827988,0.8188976377952756,49,78,52,75,39,13,10,65
10,39,0.010327053256332874,0.8188976377952756,49,78,52,75,39,13,10,65
10,40,0.010111426003277302,0.8267716535433071,50,77,52,75,40,12,10,65
10,41,0.00966909620910883,0.84251968503937,52,75,52,75,42,10,10,65
10,42,0.008940065279603004,0.8503937007874016,53,74,52,75,43,9,10,65
10,43,0.008574786596000195,0.84251968503937,54,73,52,75,43,9,11,64
10,44,0.008382370695471764,0.8503937007874016,55,72,52,75,44,8,11,64
10,45,0.007933638989925385,0.8503937007874016,55,72,52,75,44,8,11,64
10,46,0.007813630625605583,0.8503937007874016,55,72,52,75,44,8,11,64
10,47,0.007490161340683699,0.8503937007874016,55,72,52,75,44,8,11,64
10,48,0.007142325397580862,0.8503937007874016,55,72,52,75,44,8,11,64
10,49,0.006799811497330666,0.8582677165354331,56,71,52,75,45,7,11,64
11,0,0.7017942667007446,0.4094488188976378,127,0,52,75,52,0,75,0
11,1,1.9244009256362915,0.5905511811023622,0,127,52,75,0,52,0,75
11,2,0.3786601424217224,0.5905511811023622,0,127,52,75,0,52,0,75
11,3,0.726789653301239,0.5905511811023622,0,127,52,75,0,52,0,75
11,4,0.30637967586517334,0.5905511811023622,0,127,52,75,0,52,0,75
11,5,0.2226843237876892,0.5905511811023622,0,127,52,75,0,52,0,75
11,6,0.24833017587661743,0.5905511811023622,0,127,52,75,0,52,0,75
11,7,0.2563847601413727,0.5905511811023622,0,127,52,75,0,52,0,75
11,8,0.2401694506406784,0.5905511811023622,0,127,52,75,0,52,0,75
11,9,0.21803879737854004,0.5905511811023622,0,127,52,75,0,52,0,75
11,10,0.19563427567481995,0.5905511811023622,0,127,52,75,0,52,0,75
11,11,0.17889641225337982,0.5984251968503937,1,126,52,75,1,51,0,75
11,12,0.1637544184923172,0.5984251968503937,1,126,52,75,1,51,0,75
11,13,0.1485656052827835,0.5984251968503937,1,126,52,75,1,51,0,75
11,14,0.13129717111587524,0.5984251968503937,1,126,52,75,1,51,0,75
11,15,0.11622534692287445,0.6062992125984252,2,125,52,75,2,50,0,75
11,16,0.10004673898220062,0.6299212598425197,5,122,52,75,5,47,0,75
11,17,0.08683634549379349,0.6377952755905512,8,119,52,75,7,45,1,74
11,18,0.07718173414468765,0.6692913385826772,12,115,52,75,11,41,1,74
11,19,0.06938304007053375,0.6614173228346457,13,114,52,75,11,41,2,73
11,20,0.062328703701496124,0.6692913385826772,14,113,52,75,12,40,2,73
11,21,0.05528566241264343,0.7165354330708661,20,107,52,75,18,34,2,73
11,22,0.04916105419397354,0.7244094488188977,21,106,52,75,19,33,2,73
11,23,0.04343218356370926,0.7401574803149606,23,104,52,75,21,31,2,73
11,24,0.038196854293346405,0.7480314960629921,26,101,52,75,23,29,3,72
11,25,0.033955130726099014,0.7480314960629921,28,99,52,75,24,28,4,71
11,26,0.03101389855146408,0.7637795275590551,32,95,52,75,27,25,5,70
11,27,0.028115704655647278,0.7716535433070866,33,94,52,75,28,24,5,70
11,28,0.025321703404188156,0.8031496062992126,37,90,52,75,32,20,5,70
11,29,0.023923302069306374,0.8188976377952756,39,88,52,75,34,18,5,70
11,30,0.021016262471675873,0.8110236220472441,40,87,52,75,34,18,6,69
11,31,0.019511200487613678,0.8031496062992126,45,82,52,75,36,16,9,66
11,32,0.0177957471460104,0.8031496062992126,49,78,52,75,38,14,11,64
11,33,0.01686963438987732,0.8188976377952756,51,76,52,75,40,12,11,64
11,34,0.015509123913943768,0.8188976377952756,51,76,52,75,40,12,11,64
11,35,0.01423998735845089,0.8188976377952756,53,74,52,75,41,11,12,63
11,36,0.013493325561285019,0.8188976377952756,53,74,52,75,41,11,12,63
11,37,0.012769126333296299,0.8110236220472441,54,73,52,75,41,11,13,62
11,38,0.011883108876645565,0.8110236220472441,54,73,52,75,41,11,13,62
11,39,0.011401060968637466,0.8110236220472441,54,73,52,75,41,11,13,62
11,40,0.010828654281795025,0.8110236220472441,54,73,52,75,41,11,13,62
11,41,0.010313568636775017,0.8110236220472441,54,73,52,75,41,11,13,62
11,42,0.009828728623688221,0.8110236220472441,54,73,52,75,41,11,13,62
11,43,0.009474127553403378,0.8110236220472441,54,73,52,75,41,11,13,62
11,44,0.009413271211087704,0.8110236220472441,54,73,52,75,41,11,13,62
11,45,0.008893512189388275,0.8110236220472441,54,73,52,75,41,11,13,62
11,46,0.008591467514634132,0.8110236220472441,54,73,52,75,41,11,13,62
11,47,0.008321225643157959,0.8110236220472441,54,73,52,75,41,11,13,62
11,48,0.007859701290726662,0.8110236220472441,54,73,52,75,41,11,13,62
11,49,0.007188121788203716,0.8110236220472441,54,73,52,75,41,11,13,62
12,0,0.7095178961753845,0.4094488188976378,127,0,52,75,52,0,75,0
12,1,2.0607266426086426,0.5905511811023622,0,127,52,75,0,52,0,75
12,2,0.3661794662475586,0.5905511811023622,0,127,52,75,0,52,0,75
12,3,0.7892234325408936,0.5905511811023622,0,127,52,75,0,52,0,75
12,4,0.27512648701667786,0.5905511811023622,0,127,52,75,0,52,0,75
12,5,0.20692776143550873,0.5905511811023622,0,127,52,75,0,52,0,75
12,6,0.24083316326141357,0.5905511811023622,0,127,52,75,0,52,0,75
12,7,0.24209845066070557,0.5905511811023622,0,127,52,75,0,52,0,75
12,8,0.22033196687698364,0.5905511811023622,0,127,52,75,0,52,0,75
12,9,0.19812951982021332,0.5905511811023622,0,127,52,75,0,52,0,75
12,10,0.183396577835083,0.5905511811023622,0,127,52,75,0,52,0,75
12,11,0.17280380427837372,0.5905511811023622,0,127,52,75,0,52,0,75
12,12,0.16226114332675934,0.5905511811023622,0,127,52,75,0,52,0,75
12,13,0.1483946144580841,0.5905511811023622,0,127,52,75,0,52,0,75
12,14,0.12970910966396332,0.5905511811023622,0,127,52,75,0,52,0,75
12,15,0.11174702644348145,0.5905511811023622,0,127,52,75,0,52,0,75
12,16,0.09709560126066208,0.5905511811023622,0,127,52,75,0,52,0,75
12,17,0.0853014886379242,0.5905511811023622,0,127,52,75,0,52,0,75
12,18,0.076823391020298,0.5905511811023622,0,127,52,75,0,52,0,75
12,19,0.06856527924537659,0.5905511811023622,0,127,52,75,0,52,0,75
12,20,0.06282863020896912,0.6062992125984252,2,125,52,75,2,50,0,75
12,21,0.05531419441103935,0.6141732283464567,3,124,52,75,3,49,0,75
12,22,0.048736948519945145,0.6299212598425197,5,122,52,75,5,47,0,75
12,23,0.04184151068329811,0.6377952755905512,6,121,52,75,6,46,0,75
12,24,0.03697710111737251,0.6614173228346457,9,118,52,75,9,43,0,75
12,25,0.033457472920417786,0.6771653543307087,13,114,52,75,12,40,1,74
12,26,0.030741963535547256,0.6929133858267716,15,112,52,75,14,38,1,74
12,27,0.028439361602067947,0.7165354330708661,22,105,52,75,19,33,3,72
12,28,0.026127591729164124,0.7401574803149606,25,102,52,75,22,30,3,72
12,29,0.023723958060145378,0.7559055118110236,29,98,52,75,25,27,4,71
12,30,0.02177034690976143,0.7637795275590551,32,95,52,75,27,25,5,70
12,31,0.02010735310614109,0.7716535433070866,33,94,52,75,28,24,5,70
12,32,0.018639111891388893,0.7795275590551181,36,91,52,75,30,22,6,69
12,33,0.017069624736905098,0.7716535433070866,39,88,52,75,31,21,8,67
12,34,0.015794582664966583,0.7795275590551181,42,85,52,75,33,19,9,66
12,35,0.014601901173591614,0.7874015748031497,43,84,52,75,34,18,9,66
12,36,0.014129305258393288,0.7874015748031497,47,80,52,75,36,16,11,64
12,37,0.013665375299751759,0.7952755905511811,48,79,52,75,37,15,11,64
12,38,0.012559804134070873,0.7874015748031497,49,78,52,75,37,15,12,63
12,39,0.011556466110050678,0.7874015748031497,49,78,52,75,37,15,12,63
12,40,0.011067219078540802,0.7874015748031497,49,78,52,75,37,15,12,63
12,41,0.010481360368430614,0.7874015748031497,51,76,52,75,38,14,13,62
12,42,0.009844914078712463,0.7874015748031497,51,76,52,75,38,14,13,62
12,43,0.009252534247934818,0.7874015748031497,51,76,52,75,38,14,13,62
12,44,0.008960080333054066,0.7795275590551181,50,77,52,75,37,15,13,62
12,45,0.008650713600218296,0.7795275590551181,50,77,52,75,37,15,13,62
12,46,0.00847829319536686,0.7795275590551181,50,77,52,75,37,15,13,62
12,47,0.007958142086863518,0.7795275590551181,50,77,52,75,37,15,13,62
12,48,0.007310412358492613,0.7795275590551181,50,77,52,75,37,15,13,62
12,49,0.007347267586737871,0.7795275590551181,50,77,52,75,37,15,13,62
13,0,0.7012532949447632,0.5905511811023622,0,127,52,75,0,52,0,75
13,1,1.866464376449585,0.4015748031496063,126,1,52,75,51,1,75,0
13,2,0.33942902088165283,0.4015748031496063,126,1,52,75,51,1,75,0
13,3,0.28266632556915283,0.4015748031496063,126,1,52,75,51,1,75,0
13,4,0.22738350927829742,0.4015748031496063,126,1,52,75,51,1,75,0
13,5,0.21414706110954285,0.4015748031496063,126,1,52,75,51,1,75,0
13,6,0.1933431476354599,0.4015748031496063,126,1,52,75,51,1,75,0
13,7,0.17873211205005646,0.4015748031496063,126,1,52,75,51,1,75,0
13,8,0.15850690007209778,0.4015748031496063,126,1,52,75,51,1,75,0
13,9,0.13362164795398712,0.4015748031496063,126,1,52,75,51,1,75,0
13,10,0.11176324635744095,0.4015748031496063,126,1,52,75,51,1,75,0
13,11,0.09504619240760803,0.4330708661417323,122,5,52,75,51,1,71,4
13,12,0.08041469752788544,0.4566929133858268,119,8,52,75,51,1,68,7
13,13,0.06741323322057724,0.4881889763779528,115,12,52,75,51,1,64,11
13,14,0.05672949552536011,0.5039370078740157,113,14,52,75,51,1,62,13
13,15,0.047006964683532715,0.5826771653543307,103,24,52,75,51,1,52,23
13,16,0.04032011702656746,0.6299212598425197,97,30,52,75,51,1,46,29
13,17,0.03425613045692444,0.6771653543307087,87,40,52,75,49,3,38,37
13,18,0.029441963881254196,0.6929133858267716,81,46,52,75,47,5,34,41
13,19,0.0258182343095541,0.7165354330708661,70,57,52,75,43,9,27,48
13,20,0.02247798442840576,0.7637795275590551,60,67,52,75,41,11,19,56
13,21,0.019066521897912025,0.7559055118110236,55,72,52,75,38,14,17,58
13,22,0.016569165512919426,0.7559055118110236,51,76,52,75,36,16,15,60
13,23,0.014978556893765926,0.7401574803149606,45,82,52,75,32,20,13,62
13,24,0.013214043341577053,0.7244094488188977,43,84,52,75,30,22,13,62
13,25,0.01148731354624033,0.7244094488188977,39,88,52,75,28,24,11,64
13,26,0.01059049367904663,0.7165354330708661,34,93,52,75,25,27,9,66
13,27,0.009953426197171211,0.7165354330708661,34,93,52,75,25,27,9,66
13,28,0.009005214087665081,0.7007874015748031,32,95,52,75,23,29,9,66
13,29,0.008970875293016434,0.7086614173228346,31,96,52,75,23,29,8,67
13,30,0.007807874120771885,0.7086614173228346,31,96,52,75,23,29,8,67
13,31,0.0072180661372840405,0.7086614173228346,29,98,52,75,22,30,7,68
13,32,0.006601360160857439,0.7007874015748031,30,97,52,75,22,30,8,67
13,33,0.006768766790628433,0.6929133858267716,29,98,52,75,21,31,8,67
13,34,0.00583184789866209,0.6850393700787402,30,97,52,75,21,31,9,66
13,35,0.00604755524545908,0.6850393700787402,30,97,52,75,21,31,9,66
13,36,0.005254742689430714,0.6850393700787402,30,97,52,75,21,31,9,66
13,37,0.005525171756744385,0.6929133858267716,31,96,52,75,22,30,9,66
13,38,0.005239818710833788,0.6929133858267716,31,96,52,75,22,30,9,66
13,39,0.004917022306472063,0.7007874015748031,34,93,52,75,24,28,10,65
13,40,0.0048368233256042,0.7007874015748031,36,91,52,75,25,27,11,64
13,41,0.006353084463626146,0.7007874015748031,36,91,52,75,25,27,11,64
13,42,0.004780419636517763,0.7086614173228346,37,90,52,75,26,26,11,64
13,43,0.004975077696144581,0.7165354330708661,38,89,52,75,27,25,11,64
13,44,0.004932074807584286,0.7165354330708661,38,89,52,75,27,25,11,64
13,45,0.004020052496343851,0.7244094488188977,39,88,52,75,28,24,11,64
13,46,0.0041468506678938866,0.7401574803149606,41,86,52,75,30,22,11,64
13,47,0.004120952449738979,0.7480314960629921,42,85,52,75,31,21,11,64
13,48,0.004147855099290609,0.7559055118110236,43,84,52,75,32,20,11,64
13,49,0.004260096233338118,0.7480314960629921,44,83,52,75,32,20,12,63
14,0,0.6947413682937622,0.5826771653543307,0,127,53,74,0,53,0,74
14,1,2.091923952102661,0.41732283464566927,127,0,53,74,53,0,74,0
14,2,0.28249844908714294,0.41732283464566927,127,0,53,74,53,0,74,0
14,3,0.2835461497306824,0.41732283464566927,127,0,53,74,53,0,74,0
14,4,0.19055593013763428,0.41732283464566927,127,0,53,74,53,0,74,0
14,5,0.1950109601020813,0.41732283464566927,127,0,53,74,53,0,74,0
14,6,0.17735952138900757,0.41732283464566927,127,0,53,74,53,0,74,0
14,7,0.16451404988765717,0.41732283464566927,127,0,53,74,53,0,74,0
14,8,0.1531611829996109,0.41732283464566927,127,0,53,74,53,0,74,0
14,9,0.12996216118335724,0.41732283464566927,127,0,53,74,53,0,74,0
14,10,0.10880138725042343,0.41732283464566927,127,0,53,74,53,0,74,0
14,11,0.09226629883050919,0.4330708661417323,125,2,53,74,53,0,72,2
14,12,0.08019696921110153,0.4566929133858268,122,5,53,74,53,0,69,5
14,13,0.06599856168031693,0.5196850393700787,112,15,53,74,52,1,60,14
14,14,0.05575437843799591,0.5669291338582677,102,25,53,74,50,3,52,22
14,15,0.0465090312063694,0.6220472440944882,95,32,53,74,50,3,45,29
14,16,0.039886411279439926,0.6692913385826772,89,38,53,74,50,3,39,35
14,17,0.03430762514472008,0.7244094488188977,80,47,53,74,49,4,31,43
14,18,0.02925390563905239,0.7795275590551181,69,58,53,74,47,6,22,52
14,19,0.02485840395092964,0.7637795275590551,57,70,53,74,40,13,17,57
14,20,0.021060802042484283,0.8188976377952756,50,77,53,74,40,13,10,64
14,21,0.01884852536022663,0.8188976377952756,48,79,53,74,39,14,9,65
14,22,0.017008962109684944,0.8188976377952756,46,81,53,74,38,15,8,66
14,23,0.01563362218439579,0.8031496062992126,42,85,53,74,35,18,7,67
14,24,0.01361684501171112,0.7874015748031497,40,87,53,74,33,20,7,67
14,25,0.01247414480894804,0.7874015748031497,40,87,53,74,33,20,7,67
14,26,0.010932698845863342,0.7795275590551181,39,88,53,74,32,21,7,67
14,27,0.010139651596546173,0.7716535433070866,38,89,53,74,31,22,7,67
14,28,0.009366201236844063,0.7637795275590551,35,92,53,74,29,24,6,68
14,29,0.008743738755583763,0.7480314960629921,33,94,53,74,27,26,6,68
14,30,0.007993913255631924,0.7401574803149606,32,95,53,74,26,27,6,68
14,31,0.00797511637210846,0.7480314960629921,33,94,53,74,27,26,6,68
14,32,0.007404204923659563,0.7559055118110236,34,93,53,74,28,25,6,68
14,33,0.006886669434607029,0.7637795275590551,35,92,53,74,29,24,6,68
14,34,0.0071974159218370914,0.7637795275590551,35,92,53,74,29,24,6,68
14,35,0.0062153819017112255,0.7716535433070866,36,91,53,74,30,23,6,68
14,36,0.006225716322660446,0.7716535433070866,36,91,53,74,30,23,6,68
14,37,0.006090253591537476,0.7716535433070866,36,91,53,74,30,23,6,68
14,38,0.005820550490170717,0.7637795275590551,37,90,53,74,30,23,7,67
14,39,0.0055474271066486835,0.7637795275590551,37,90,53,74,30,23,7,67
14,40,0.005371172446757555,0.7637795275590551,37,90,53,74,30,23,7,67
14,41,0.005391001235693693,0.7637795275590551,37,90,53,74,30,23,7,67
14,42,0.0052630058489739895,0.7716535433070866,38,89,53,74,31,22,7,67
14,43,0.005008144304156303,0.7716535433070866,38,89,53,74,31,22,7,67
14,44,0.004777494817972183,0.7795275590551181,39,88,53,74,32,21,7,67
14,45,0.005262134131044149,0.8031496062992126,42,85,53,74,35,18,7,67
14,46,0.0045656366273760796,0.8188976377952756,44,83,53,74,37,16,7,67
14,47,0.004576775245368481,0.8188976377952756,44,83,53,74,37,16,7,67
14,48,0.0043440889567136765,0.8188976377952756,44,83,53,74,37,16,7,67
14,49,0.004467688500881195,0.8188976377952756,44,83,53,74,37,16,7,67
15,0,0.6882765889167786,0.41732283464566927,127,0,53,74,53,0,74,0
15,1,0.6431354880332947,0.5826771653543307,0,127,53,74,0,53,0,74
15,2,1.2898999452590942,0.7244094488188977,24,103,53,74,21,32,3,71
15,3,0.35441824793815613,0.4409448818897638,122,5,53,74,52,1,70,4
15,4,0.24498341977596283,0.41732283464566927,127,0,53,74,53,0,74,0
15,5,0.29849547147750854,0.41732283464566927,127,0,53,74,53,0,74,0
15,6,0.2672708034515381,0.48031496062992124,117,10,53,74,52,1,65,9
15,7,0.20980304479599,0.7874015748031497,30,97,53,74,28,25,2,72
15,8,0.17728878557682037,0.5826771653543307,0,127,53,74,0,53,0,74
15,9,0.1731584370136261,0.5826771653543307,0,127,53,74,0,53,0,74
15,10,0.1750427633523941,0.5826771653543307,0,127,53,74,0,53,0,74
15,11,0.16928529739379883,0.5826771653543307,0,127,53,74,0,53,0,74
15,12,0.15399961173534393,0.6456692913385826,8,119,53,74,8,45,0,74
15,13,0.13268420100212097,0.7165354330708661,83,44,53,74,50,3,33,41
15,14,0.11416701972484589,0.4409448818897638,124,3,53,74,53,0,71,3
15,15,0.10118719935417175,0.4251968503937008,126,1,53,74,53,0,73,1
15,16,0.09282545745372772,0.41732283464566927,127,0,53,74,53,0,74,0
15,17,0.08707641810178757,0.41732283464566927,127,0,53,74,53,0,74,0
15,18,0.08073767274618149,0.41732283464566927,127,0,53,74,53,0,74,0
15,19,0.07218257337808609,0.4251968503937008,126,1,53,74,53,0,73,1
15,20,0.06269446015357971,0.4251968503937008,126,1,53,74,53,0,73,1
15,21,0.05484112352132797,0.4251968503937008,126,1,53,74,53,0,73,1
15,22,0.04832860454916954,0.4330708661417323,125,2,53,74,53,0,72,2
15,23,0.04362611100077629,0.4409448818897638,124,3,53,74,53,0,71,3
15,24,0.03981315717101097,0.48031496062992124,119,8,53,74,53,0,66,8
15,25,0.03720976039767265,0.5196850393700787,114,13,53,74,53,0,61,13
15,26,0.03368053585290909,0.5590551181102362,109,18,53,74,53,0,56,18
15,27,0.03046092577278614,0.5748031496062992,107,20,53,74,53,0,54,20
15,28,0.027735775336623192,0.6141732283464567,102,25,53,74,53,0,49,25
15,29,0.025200653821229935,0.6456692913385826,98,29,53,74,53,0,45,29
15,30,0.022477298974990845,0.6535433070866141,93,34,53,74,51,2,42,32
15,31,0.020694073289632797,0.7086614173228346,86,41,53,74,51,2,35,39
15,32,0.019432533532381058,0.7244094488188977,84,43,53,74,51,2,33,41
15,33,0.01840534433722496,0.7401574803149606,82,45,53,74,51,2,31,43
15,34,0.01690422184765339,0.7322834645669292,81,46,53,74,50,3,31,43
15,35,0.01592216081917286,0.7480314960629921,75,52,53,74,48,5,27,47
15,36,0.014915972016751766,0.7559055118110236,74,53,53,74,48,5,26,48
15,37,0.014032665640115738,0.7795275590551181,71,56,53,74,48,5,23,51
15,38,0.01329947728663683,0.7795275590551181,69,58,53,74,47,6,22,52
15,39,0.012126371264457703,0.7952755905511811,67,60,53,74,47,6,20,54
15,40,0.01193066406995058,0.7952755905511811,67,60,53,74,47,6,20,54
15,41,0.010896087624132633,0.8110236220472441,63,64,53,74,46,7,17,57
15,42,0.010171579197049141,0.8188976377952756,62,65,53,74,46,7,16,58
15,43,0.010015410371124744,0.8188976377952756,62,65,53,74,46,7,16,58
15,44,0.009332912974059582,0.8110236220472441,61,66,53,74,45,8,16,58
15,45,0.008901461027562618,0.8188976377952756,58,69,53,74,44,9,14,60
15,46,0.008510889485478401,0.8188976377952756,58,69,53,74,44,9,14,60
15,47,0.008626589551568031,0.8188976377952756,58,69,53,74,44,9,14,60
15,48,0.008435514755547047,0.8346456692913385,56,71,53,74,44,9,12,62
15,49,0.008057259023189545,0.84251968503937,55,72,53,74,44,9,11,63
