Fold,Epoch,Loss,Accuracy,Pred_Real,Pred_Fake,True_Real,True_Fake,TN,FP,FN,TP
1,0,0.8602063059806824,0.5859375,0,128,53,75,0,53,0,75
1,1,8.274452209472656,0.5859375,0,128,53,75,0,53,0,75
1,2,1.9750690460205078,0.5859375,0,128,53,75,0,53,0,75
1,3,0.7090948820114136,0.4140625,128,0,53,75,53,0,75,0
1,4,0.7173672318458557,0.4140625,128,0,53,75,53,0,75,0
1,5,0.7640793919563293,0.4140625,128,0,53,75,53,0,75,0
1,6,0.770818293094635,0.4140625,128,0,53,75,53,0,75,0
1,7,0.7553628087043762,0.4140625,128,0,53,75,53,0,75,0
1,8,0.7292763590812683,0.4140625,128,0,53,75,53,0,75,0
1,9,0.7133707404136658,0.4140625,128,0,53,75,53,0,75,0
1,10,0.6913533806800842,0.40625,127,1,53,75,52,1,75,0
1,11,0.6715340614318848,0.4140625,120,8,53,75,49,4,71,4
1,12,0.6513217687606812,0.4609375,106,22,53,75,45,8,61,14
1,13,0.6483567953109741,0.59375,89,39,53,75,45,8,44,31
1,14,0.6395359635353088,0.609375,87,41,53,75,45,8,42,33
1,15,0.6270274519920349,0.5625,83,45,53,75,40,13,43,32
1,16,0.6158534288406372,0.5703125,80,48,53,75,39,14,41,34
1,17,0.6038128733634949,0.59375,81,47,53,75,41,12,40,35
1,18,0.5942198634147644,0.6015625,80,48,53,75,41,12,39,36
1,19,0.5811519026756287,0.59375,77,51,53,75,39,14,38,37
1,20,0.5684707164764404,0.5859375,76,52,53,75,38,15,38,37
1,21,0.5601155161857605,0.578125,75,53,53,75,37,16,38,37
1,22,0.5578694343566895,0.578125,75,53,53,75,37,16,38,37
1,23,0.5347165465354919,0.5859375,74,54,53,75,37,16,37,38
1,24,0.5226181745529175,0.609375,73,55,53,75,38,15,35,40
1,25,0.5118305683135986,0.609375,73,55,53,75,38,15,35,40
1,26,0.5107265710830688,0.6015625,76,52,53,75,39,14,37,38
1,27,0.49965760111808777,0.609375,75,53,53,75,39,14,36,39
1,28,0.4852176904678345,0.6171875,76,52,53,75,40,13,36,39
1,29,0.4852958023548126,0.6171875,76,52,53,75,40,13,36,39
1,30,0.4733092486858368,0.6015625,76,52,53,75,39,14,37,38
1,31,0.4500654339790344,0.6015625,76,52,53,75,39,14,37,38
1,32,0.4399937689304352,0.6328125,74,54,53,75,40,13,34,41
1,33,0.442628413438797,0.6328125,74,54,53,75,40,13,34,41
1,34,0.435129314661026,0.640625,71,57,53,75,39,14,32,43
1,35,0.42017272114753723,0.6796875,66,62,53,75,39,14,27,48
1,36,0.4161783754825592,0.6875,65,63,53,75,39,14,26,49
1,37,0.4097708761692047,0.6796875,64,64,53,75,38,15,26,49
1,38,0.39090293645858765,0.6953125,62,66,53,75,38,15,24,51
1,39,0.39466825127601624,0.703125,61,67,53,75,38,15,23,52
1,40,0.3684242367744446,0.6875,63,65,53,75,38,15,25,50
1,41,0.3727565407752991,0.6875,63,65,53,75,38,15,25,50
1,42,0.35583752393722534,0.6875,63,65,53,75,38,15,25,50
1,43,0.3603263199329376,0.671875,63,65,53,75,37,16,26,49
1,44,0.350067138671875,0.671875,63,65,53,75,37,16,26,49
1,45,0.32920604944229126,0.671875,63,65,53,75,37,16,26,49
1,46,0.3316786587238312,0.671875,63,65,53,75,37,16,26,49
1,47,0.35245415568351746,0.6875,61,67,53,75,37,16,24,51
1,48,0.3222304880619049,0.6953125,60,68,53,75,37,16,23,52
1,49,0.32498034834861755,0.6875,61,67,53,75,37,16,24,51
2,0,0.7031362056732178,0.4094488188976378,127,0,52,75,52,0,75,0
2,1,7.635605335235596,0.4094488188976378,127,0,52,75,52,0,75,0
2,2,1.4936800003051758,0.7244094488188977,19,108,52,75,18,34,1,74
2,3,0.6592376232147217,0.5905511811023622,0,127,52,75,0,52,0,75
2,4,1.145714521408081,0.5905511811023622,0,127,52,75,0,52,0,75
2,5,0.9564598798751831,0.5984251968503937,1,126,52,75,1,51,0,75
2,6,0.7164371013641357,0.6062992125984252,4,123,52,75,3,49,1,74
2,7,0.5745701193809509,0.6614173228346457,13,114,52,75,11,41,2,73
2,8,0.5030263662338257,0.7637795275590551,36,91,52,75,29,23,7,68
2,9,0.47396376729011536,0.7795275590551181,34,93,52,75,29,23,5,70
2,10,0.42814892530441284,0.6614173228346457,13,114,52,75,11,41,2,73
2,11,0.4256640672683716,0.6929133858267716,15,112,52,75,14,38,1,74
2,12,0.3494422733783722,0.6929133858267716,15,112,52,75,14,38,1,74
2,13,0.30618414282798767,0.6614173228346457,11,116,52,75,10,42,1,74
2,14,0.2581996023654938,0.7007874015748031,16,111,52,75,15,37,1,74
2,15,0.23216331005096436,0.7322834645669292,20,107,52,75,19,33,1,74
2,16,0.20307870209217072,0.7480314960629921,22,105,52,75,21,31,1,74
2,17,0.1863175481557846,0.7795275590551181,26,101,52,75,25,27,1,74
2,18,0.17306318879127502,0.7874015748031497,27,100,52,75,26,26,1,74
2,19,0.1352783441543579,0.7952755905511811,28,99,52,75,27,25,1,74
2,20,0.12246885895729065,0.7795275590551181,30,97,52,75,27,25,3,72
2,21,0.11214456707239151,0.7795275590551181,32,95,52,75,28,24,4,71
2,22,0.08925813436508179,0.7874015748031497,35,92,52,75,30,22,5,70
2,23,0.08707845956087112,0.7874015748031497,37,90,52,75,31,21,6,69
2,24,0.09024973213672638,0.7874015748031497,39,88,52,75,32,20,7,68
2,25,0.07027307152748108,0.7716535433070866,41,86,52,75,32,20,9,66
2,26,0.0645298957824707,0.7795275590551181,42,85,52,75,33,19,9,66
2,27,0.06165165826678276,0.7952755905511811,44,83,52,75,35,17,9,66
2,28,0.06100345775485039,0.7952755905511811,44,83,52,75,35,17,9,66
2,29,0.06022347882390022,0.7874015748031497,43,84,52,75,34,18,9,66
2,30,0.05528983473777771,0.7952755905511811,42,85,52,75,34,18,8,67
2,31,0.054962437599897385,0.7952755905511811,42,85,52,75,34,18,8,67
2,32,0.06166355311870575,0.8110236220472441,44,83,52,75,36,16,8,67
2,33,0.046125903725624084,0.8110236220472441,44,83,52,75,36,16,8,67
2,34,0.05205108970403671,0.8188976377952756,43,84,52,75,36,16,7,68
2,35,0.04473382607102394,0.8031496062992126,45,82,52,75,36,16,9,66
2,36,0.039958346635103226,0.8031496062992126,45,82,52,75,36,16,9,66
2,37,0.041234493255615234,0.8031496062992126,45,82,52,75,36,16,9,66
2,38,0.034652821719646454,0.8110236220472441,44,83,52,75,36,16,8,67
2,39,0.03275204449892044,0.8110236220472441,42,85,52,75,35,17,7,68
2,40,0.041564468294382095,0.8110236220472441,40,87,52,75,34,18,6,69
2,41,0.03571968153119087,0.8110236220472441,40,87,52,75,34,18,6,69
2,42,0.033545397222042084,0.8188976377952756,41,86,52,75,35,17,6,69
2,43,0.02797051891684532,0.8031496062992126,43,84,52,75,35,17,8,67
2,44,0.029175464063882828,0.8188976377952756,41,86,52,75,35,17,6,69
2,45,0.03034236468374729,0.8188976377952756,41,86,52,75,35,17,6,69
2,46,0.033150143921375275,0.8267716535433071,42,85,52,75,36,16,6,69
2,47,0.02668117545545101,0.8188976377952756,43,84,52,75,36,16,7,68
2,48,0.025844931602478027,0.8110236220472441,42,85,52,75,35,17,7,68
2,49,0.027060726657509804,0.8110236220472441,42,85,52,75,35,17,7,68
3,0,0.7015328407287598,0.5905511811023622,0,127,52,75,0,52,0,75
3,1,8.772006034851074,0.5905511811023622,0,127,52,75,0,52,0,75
3,2,1.5799685716629028,0.4094488188976378,127,0,52,75,52,0,75,0
3,3,0.6740030646324158,0.4094488188976378,127,0,52,75,52,0,75,0
3,4,0.8922747373580933,0.4094488188976378,127,0,52,75,52,0,75,0
3,5,0.8528071045875549,0.4094488188976378,127,0,52,75,52,0,75,0
3,6,0.7724636197090149,0.4094488188976378,127,0,52,75,52,0,75,0
3,7,0.7292195558547974,0.4094488188976378,127,0,52,75,52,0,75,0
3,8,0.70505690574646,0.4094488188976378,127,0,52,75,52,0,75,0
3,9,0.6938523054122925,0.4094488188976378,127,0,52,75,52,0,75,0
3,10,0.6809243559837341,0.4251968503937008,123,4,52,75,51,1,72,3
3,11,0.6633438467979431,0.5118110236220472,112,15,52,75,51,1,61,14
3,12,0.6387343406677246,0.6535433070866141,88,39,52,75,48,4,40,35
3,13,0.5984101295471191,0.7401574803149606,51,76,52,75,35,17,16,59
3,14,0.5606475472450256,0.7637795275590551,56,71,52,75,39,13,17,58
3,15,0.522152304649353,0.7637795275590551,68,59,52,75,45,7,23,52
3,16,0.45304036140441895,0.7401574803149606,83,44,52,75,51,1,32,43
3,17,0.42324474453926086,0.6771653543307087,93,34,52,75,52,0,41,34
3,18,0.37501847743988037,0.6299212598425197,99,28,52,75,52,0,47,28
3,19,0.37688738107681274,0.6456692913385826,97,30,52,75,52,0,45,30
3,20,0.32325518131256104,0.6850393700787402,92,35,52,75,52,0,40,35
3,21,0.30229640007019043,0.6850393700787402,92,35,52,75,52,0,40,35
3,22,0.26742008328437805,0.6535433070866141,96,31,52,75,52,0,44,31
3,23,0.23829729855060577,0.6377952755905512,98,29,52,75,52,0,46,29
3,24,0.21974366903305054,0.6377952755905512,98,29,52,75,52,0,46,29
3,25,0.21335731446743011,0.7086614173228346,89,38,52,75,52,0,37,38
3,26,0.2011692225933075,0.7244094488188977,85,42,52,75,51,1,34,41
3,27,0.1682952642440796,0.7401574803149606,85,42,52,75,52,0,33,42
3,28,0.19324959814548492,0.7401574803149606,81,46,52,75,50,2,31,44
3,29,0.1615113466978073,0.7401574803149606,81,46,52,75,50,2,31,44
3,30,0.13881318271160126,0.7480314960629921,78,49,52,75,49,3,29,46
3,31,0.12912289798259735,0.8110236220472441,70,57,52,75,49,3,21,54
3,32,0.1283213347196579,0.8110236220472441,62,65,52,75,45,7,17,58
3,33,0.12305797636508942,0.8267716535433071,60,67,52,75,45,7,15,60
3,34,0.11192630231380463,0.8188976377952756,61,66,52,75,45,7,16,59
3,35,0.10348916053771973,0.8188976377952756,61,66,52,75,45,7,16,59
3,36,0.08908926695585251,0.8188976377952756,63,64,52,75,46,6,17,58
3,37,0.11023292690515518,0.8267716535433071,60,67,52,75,45,7,15,60
3,38,0.11326837539672852,0.84251968503937,58,69,52,75,45,7,13,62
3,39,0.09621111303567886,0.8582677165354331,54,73,52,75,44,8,10,65
3,40,0.1325770914554596,0.84251968503937,56,71,52,75,44,8,12,63
3,41,0.09404738992452621,0.84251968503937,58,69,52,75,45,7,13,62
3,42,0.09284477680921555,0.8267716535433071,60,67,52,75,45,7,15,60
3,43,0.09772137552499771,0.84251968503937,58,69,52,75,45,7,13,62
3,44,0.09289003908634186,0.8346456692913385,57,70,52,75,44,8,13,62
3,45,0.07410292327404022,0.84251968503937,52,75,52,75,42,10,10,65
3,46,0.08652956783771515,0.8188976377952756,49,78,52,75,39,13,10,65
3,47,0.09339138120412827,0.84251968503937,52,75,52,75,42,10,10,65
3,48,0.0766749456524849,0.8503937007874016,59,68,52,75,46,6,13,62
3,49,0.06893476098775864,0.8503937007874016,59,68,52,75,46,6,13,62
4,0,0.9504480957984924,0.5905511811023622,0,127,52,75,0,52,0,75
4,1,7.477809429168701,0.5905511811023622,0,127,52,75,0,52,0,75
4,2,2.310357093811035,0.5905511811023622,0,127,52,75,0,52,0,75
4,3,0.6917591094970703,0.4094488188976378,127,0,52,75,52,0,75,0
4,4,0.7152441143989563,0.4094488188976378,127,0,52,75,52,0,75,0
4,5,0.7341167330741882,0.4094488188976378,127,0,52,75,52,0,75,0
4,6,0.700652003288269,0.4094488188976378,127,0,52,75,52,0,75,0
4,7,0.7065539956092834,0.4094488188976378,127,0,52,75,52,0,75,0
4,8,0.6514516472816467,0.4094488188976378,127,0,52,75,52,0,75,0
4,9,0.623432993888855,0.41732283464566927,126,1,52,75,52,0,74,1
4,10,0.6079484224319458,0.4409448818897638,123,4,52,75,52,0,71,4
4,11,0.5590382218360901,0.4645669291338583,116,11,52,75,50,2,66,9
4,12,0.5546973943710327,0.5039370078740157,107,20,52,75,48,4,59,16
4,13,0.5221298336982727,0.5905511811023622,92,35,52,75,46,6,46,29
4,14,0.4848651885986328,0.7086614173228346,73,54,52,75,44,8,29,46
4,15,0.4750085473060608,0.7480314960629921,56,71,52,75,38,14,18,57
4,16,0.44800758361816406,0.7165354330708661,44,83,52,75,30,22,14,61
4,17,0.4131774306297302,0.6535433070866141,32,95,52,75,20,32,12,63
4,18,0.4254651665687561,0.6614173228346457,29,98,52,75,19,33,10,65
4,19,0.386160671710968,0.6535433070866141,28,99,52,75,18,34,10,65
4,20,0.3666040599346161,0.6771653543307087,33,94,52,75,22,30,11,64
4,21,0.35051068663597107,0.7322834645669292,38,89,52,75,28,24,10,65
4,22,0.32306987047195435,0.7637795275590551,42,85,52,75,32,20,10,65
4,23,0.326217383146286,0.7795275590551181,46,81,52,75,35,17,11,64
4,24,0.29903444647789,0.7716535433070866,49,78,52,75,36,16,13,62
4,25,0.2834961414337158,0.8031496062992126,51,76,52,75,39,13,12,63
4,26,0.26866021752357483,0.8267716535433071,54,73,52,75,42,10,12,63
4,27,0.2507244944572449,0.8346456692913385,55,72,52,75,43,9,12,63
4,28,0.24675197899341583,0.8188976377952756,55,72,52,75,42,10,13,62
4,29,0.21777628362178802,0.8110236220472441,54,73,52,75,41,11,13,62
4,30,0.20731884241104126,0.8188976377952756,57,70,52,75,43,9,14,61
4,31,0.20292510092258453,0.8031496062992126,55,72,52,75,41,11,14,61
4,32,0.18232537806034088,0.8188976377952756,55,72,52,75,42,10,13,62
4,33,0.2174927443265915,0.7952755905511811,58,69,52,75,42,10,16,59
4,34,0.17300091683864594,0.7795275590551181,62,65,52,75,43,9,19,56
4,35,0.1841808408498764,0.7795275590551181,64,63,52,75,44,8,20,55
4,36,0.18779096007347107,0.7874015748031497,65,62,52,75,45,7,20,55
4,37,0.1638893336057663,0.7716535433070866,63,64,52,75,43,9,20,55
4,38,0.17315872013568878,0.7874015748031497,55,72,52,75,40,12,15,60
4,39,0.1329767256975174,0.7795275590551181,50,77,52,75,37,15,13,62
4,40,0.14854329824447632,0.7795275590551181,52,75,52,75,38,14,14,61
4,41,0.15094415843486786,0.7795275590551181,52,75,52,75,38,14,14,61
4,42,0.13594919443130493,0.7795275590551181,52,75,52,75,38,14,14,61
4,43,0.12735354900360107,0.7795275590551181,52,75,52,75,38,14,14,61
4,44,0.12865221500396729,0.7716535433070866,59,68,52,75,41,11,18,57
4,45,0.10191807150840759,0.7637795275590551,66,61,52,75,44,8,22,53
4,46,0.12535007297992706,0.7716535433070866,67,60,52,75,45,7,22,53
4,47,0.11327831447124481,0.7716535433070866,67,60,52,75,45,7,22,53
4,48,0.10795159637928009,0.7716535433070866,65,62,52,75,44,8,21,54
4,49,0.10877630114555359,0.7716535433070866,61,66,52,75,42,10,19,56
5,0,0.7079145312309265,0.4094488188976378,127,0,52,75,52,0,75,0
5,1,8.09906005859375,0.4094488188976378,127,0,52,75,52,0,75,0
5,2,1.9338114261627197,0.25984251968503935,74,53,52,75,16,36,58,17
5,3,0.7634222507476807,0.5905511811023622,0,127,52,75,0,52,0,75
5,4,1.2667217254638672,0.5905511811023622,0,127,52,75,0,52,0,75
5,5,1.0455849170684814,0.5905511811023622,0,127,52,75,0,52,0,75
5,6,0.8011687994003296,0.5905511811023622,0,127,52,75,0,52,0,75
5,7,0.7262762784957886,0.5905511811023622,0,127,52,75,0,52,0,75
5,8,0.7010534405708313,0.5905511811023622,0,127,52,75,0,52,0,75
5,9,0.6936014294624329,0.5905511811023622,0,127,52,75,0,52,0,75
5,10,0.687757670879364,0.5905511811023622,0,127,52,75,0,52,0,75
5,11,0.6826964616775513,0.5905511811023622,0,127,52,75,0,52,0,75
5,12,0.6714606285095215,0.5984251968503937,1,126,52,75,1,51,0,75
5,13,0.6562871336936951,0.6062992125984252,4,123,52,75,3,49,1,74
5,14,0.6379281878471375,0.6692913385826772,12,115,52,75,11,41,1,74
5,15,0.6280140280723572,0.7086614173228346,41,86,52,75,28,24,13,62
5,16,0.580798864364624,0.7086614173228346,53,74,52,75,34,18,19,56
5,17,0.5507293343544006,0.7086614173228346,57,70,52,75,36,16,21,54
5,18,0.5257371664047241,0.7480314960629921,38,89,52,75,29,23,9,66
5,19,0.5036054253578186,0.7165354330708661,24,103,52,75,20,32,4,71
5,20,0.47720643877983093,0.7244094488188977,31,96,52,75,24,28,7,68
5,21,0.4458742141723633,0.7716535433070866,43,84,52,75,33,19,10,65
5,22,0.4392591416835785,0.8031496062992126,37,90,52,75,32,20,5,70
5,23,0.39925575256347656,0.7401574803149606,23,104,52,75,21,31,2,73
5,24,0.35997268557548523,0.7086614173228346,19,108,52,75,17,35,2,73
5,25,0.34087997674942017,0.7165354330708661,22,105,52,75,19,33,3,72
5,26,0.31475767493247986,0.7716535433070866,29,98,52,75,26,26,3,72
5,27,0.29797765612602234,0.7637795275590551,30,97,52,75,26,26,4,71
5,28,0.3108566999435425,0.7322834645669292,24,103,52,75,21,31,3,72
5,29,0.26029857993125916,0.7007874015748031,22,105,52,75,18,34,4,71
5,30,0.26870885491371155,0.7401574803149606,27,100,52,75,23,29,4,71
5,31,0.23831237852573395,0.7716535433070866,31,96,52,75,27,25,4,71
5,32,0.19527468085289001,0.7952755905511811,36,91,52,75,31,21,5,70
5,33,0.2367442548274994,0.7795275590551181,32,95,52,75,28,24,4,71
5,34,0.17957796156406403,0.7795275590551181,32,95,52,75,28,24,4,71
5,35,0.17231835424900055,0.7795275590551181,32,95,52,75,28,24,4,71
5,36,0.16274899244308472,0.7952755905511811,36,91,52,75,31,21,5,70
5,37,0.13975010812282562,0.8110236220472441,40,87,52,75,34,18,6,69
5,38,0.1321883499622345,0.8267716535433071,42,85,52,75,36,16,6,69
5,39,0.13800208270549774,0.8346456692913385,43,84,52,75,37,15,6,69
5,40,0.13994653522968292,0.8188976377952756,43,84,52,75,36,16,7,68
5,41,0.11840072274208069,0.8267716535433071,42,85,52,75,36,16,6,69
5,42,0.10858738422393799,0.8188976377952756,41,86,52,75,35,17,6,69
5,43,0.10765621811151505,0.8267716535433071,40,87,52,75,35,17,5,70
5,44,0.1020008996129036,0.8188976377952756,41,86,52,75,35,17,6,69
5,45,0.09101029485464096,0.8188976377952756,41,86,52,75,35,17,6,69
5,46,0.09181945025920868,0.8110236220472441,40,87,52,75,34,18,6,69
5,47,0.0859595239162445,0.8110236220472441,40,87,52,75,34,18,6,69
5,48,0.08243906497955322,0.8110236220472441,40,87,52,75,34,18,6,69
5,49,0.08415495604276657,0.8110236220472441,40,87,52,75,34,18,6,69
6,0,0.7337611317634583,0.4094488188976378,127,0,52,75,52,0,75,0
6,1,8.481046676635742,0.4094488188976378,127,0,52,75,52,0,75,0
6,2,1.8721181154251099,0.7795275590551181,32,95,52,75,28,24,4,71
6,3,0.6026886701583862,0.5905511811023622,0,127,52,75,0,52,0,75
6,4,0.9627290964126587,0.5905511811023622,0,127,52,75,0,52,0,75
6,5,1.0504549741744995,0.5905511811023622,0,127,52,75,0,52,0,75
6,6,0.9447131752967834,0.5905511811023622,0,127,52,75,0,52,0,75
6,7,0.8153203129768372,0.5905511811023622,0,127,52,75,0,52,0,75
6,8,0.7230348587036133,0.5984251968503937,1,126,52,75,1,51,0,75
6,9,0.6752287149429321,0.6299212598425197,9,118,52,75,7,45,2,73
6,10,0.661892831325531,0.7795275590551181,30,97,52,75,27,25,3,72
6,11,0.6715087890625,0.7716535433070866,39,88,52,75,31,21,8,67
6,12,0.6268852949142456,0.7874015748031497,33,94,52,75,29,23,4,71
6,13,0.5928535461425781,0.7795275590551181,26,101,52,75,25,27,1,74
6,14,0.5937498211860657,0.8110236220472441,32,95,52,75,30,22,2,73
6,15,0.5280827283859253,0.8188976377952756,51,76,52,75,40,12,11,64
6,16,0.48994559049606323,0.7952755905511811,56,71,52,75,41,11,15,60
6,17,0.46844860911369324,0.8661417322834646,47,80,52,75,41,11,6,69
6,18,0.415189653635025,0.8661417322834646,45,82,52,75,40,12,5,70
6,19,0.3612494170665741,0.8740157480314961,46,81,52,75,41,11,5,70
6,20,0.36452797055244446,0.8503937007874016,49,78,52,75,41,11,8,67
6,21,0.3291721045970917,0.8031496062992126,55,72,52,75,41,11,14,61
6,22,0.29708561301231384,0.8031496062992126,55,72,52,75,41,11,14,61
6,23,0.28640127182006836,0.8110236220472441,54,73,52,75,41,11,13,62
6,24,0.2730085551738739,0.8267716535433071,50,77,52,75,40,12,10,65
6,25,0.25372445583343506,0.8267716535433071,50,77,52,75,40,12,10,65
6,26,0.23591820895671844,0.8267716535433071,50,77,52,75,40,12,10,65
6,27,0.2287997305393219,0.8188976377952756,51,76,52,75,40,12,11,64
6,28,0.2128736674785614,0.8188976377952756,51,76,52,75,40,12,11,64
6,29,0.20496058464050293,0.8110236220472441,52,75,52,75,40,12,12,63
6,30,0.18286140263080597,0.8110236220472441,52,75,52,75,40,12,12,63
6,31,0.17348657548427582,0.8188976377952756,53,74,52,75,41,11,12,63
6,32,0.18188358843326569,0.8346456692913385,57,70,52,75,44,8,13,62
6,33,0.16119323670864105,0.8503937007874016,61,66,52,75,47,5,14,61
6,34,0.14763405919075012,0.8346456692913385,65,62,52,75,48,4,17,58
6,35,0.15779080986976624,0.8346456692913385,63,64,52,75,47,5,16,59
6,36,0.12917029857635498,0.8503937007874016,61,66,52,75,47,5,14,61
6,37,0.11647038161754608,0.8503937007874016,59,68,52,75,46,6,13,62
6,38,0.12632571160793304,0.8346456692913385,57,70,52,75,44,8,13,62
6,39,0.12214662879705429,0.8267716535433071,56,71,52,75,43,9,13,62
6,40,0.1240118145942688,0.8267716535433071,52,75,52,75,41,11,11,64
6,41,0.08932393789291382,0.8267716535433071,52,75,52,75,41,11,11,64
6,42,0.09765253961086273,0.8267716535433071,52,75,52,75,41,11,11,64
6,43,0.10653840005397797,0.8267716535433071,52,75,52,75,41,11,11,64
6,44,0.0980052500963211,0.8188976377952756,53,74,52,75,41,11,12,63
6,45,0.08598040044307709,0.8346456692913385,55,72,52,75,43,9,12,63
6,46,0.07797884196043015,0.84251968503937,56,71,52,75,44,8,12,63
6,47,0.07352082431316376,0.84251968503937,56,71,52,75,44,8,12,63
6,48,0.07631552219390869,0.8346456692913385,55,72,52,75,43,9,12,63
6,49,0.09326061606407166,0.84251968503937,56,71,52,75,44,8,12,63
7,0,0.7161010503768921,0.4094488188976378,127,0,52,75,52,0,75,0
7,1,9.505717277526855,0.4094488188976378,127,0,52,75,52,0,75,0
7,2,1.6669950485229492,0.5905511811023622,0,127,52,75,0,52,0,75
7,3,0.7086299061775208,0.5905511811023622,0,127,52,75,0,52,0,75
7,4,1.0856388807296753,0.5905511811023622,0,127,52,75,0,52,0,75
7,5,0.997416615486145,0.5905511811023622,0,127,52,75,0,52,0,75
7,6,0.8507123589515686,0.5905511811023622,0,127,52,75,0,52,0,75
7,7,0.7499774098396301,0.5905511811023622,0,127,52,75,0,52,0,75
7,8,0.6978866457939148,0.5905511811023622,0,127,52,75,0,52,0,75
7,9,0.6574362516403198,0.5905511811023622,0,127,52,75,0,52,0,75
7,10,0.6131178140640259,0.5984251968503937,3,124,52,75,2,50,1,74
7,11,0.55031818151474,0.6062992125984252,4,123,52,75,3,49,1,74
7,12,0.5402145981788635,0.5905511811023622,0,127,52,75,0,52,0,75
7,13,0.490177184343338,0.5984251968503937,1,126,52,75,1,51,0,75
7,14,0.44533571600914,0.6062992125984252,4,123,52,75,3,49,1,74
7,15,0.400130033493042,0.6299212598425197,7,120,52,75,6,46,1,74
7,16,0.35771915316581726,0.6299212598425197,7,120,52,75,6,46,1,74
7,17,0.33281615376472473,0.6062992125984252,4,123,52,75,3,49,1,74
7,18,0.31844109296798706,0.6299212598425197,7,120,52,75,6,46,1,74
7,19,0.2710654139518738,0.6377952755905512,8,119,52,75,7,45,1,74
7,20,0.2473939061164856,0.6377952755905512,8,119,52,75,7,45,1,74
7,21,0.25528445839881897,0.6220472440944882,8,119,52,75,6,46,2,73
7,22,0.2157677561044693,0.6377952755905512,10,117,52,75,8,44,2,73
7,23,0.19624999165534973,0.6535433070866141,12,115,52,75,10,42,2,73
7,24,0.19167496263980865,0.6692913385826772,14,113,52,75,12,40,2,73
7,25,0.18496745824813843,0.7165354330708661,20,107,52,75,18,34,2,73
7,26,0.16765421628952026,0.7165354330708661,24,103,52,75,20,32,4,71
7,27,0.16654159128665924,0.7322834645669292,28,99,52,75,23,29,5,70
7,28,0.1418934315443039,0.7322834645669292,30,97,52,75,24,28,6,69
7,29,0.1510867476463318,0.7480314960629921,34,93,52,75,27,25,7,68
7,30,0.13266365230083466,0.7480314960629921,32,95,52,75,26,26,6,69
7,31,0.11868366599082947,0.7637795275590551,32,95,52,75,27,25,5,70
7,32,0.1044609472155571,0.7716535433070866,35,92,52,75,29,23,6,69
7,33,0.1097496971487999,0.7716535433070866,39,88,52,75,31,21,8,67
7,34,0.10468235611915588,0.8110236220472441,44,83,52,75,36,16,8,67
7,35,0.09593121707439423,0.8110236220472441,46,81,52,75,37,15,9,66
7,36,0.09059055894613266,0.8110236220472441,44,83,52,75,36,16,8,67
7,37,0.10371780395507812,0.8110236220472441,42,85,52,75,35,17,7,68
7,38,0.0896989107131958,0.8031496062992126,41,86,52,75,34,18,7,68
7,39,0.08082382380962372,0.8110236220472441,42,85,52,75,35,17,7,68
7,40,0.08744700998067856,0.8267716535433071,44,83,52,75,37,15,7,68
7,41,0.08796205371618271,0.8188976377952756,45,82,52,75,37,15,8,67
7,42,0.07122708857059479,0.8188976377952756,47,80,52,75,38,14,9,66
7,43,0.06968864053487778,0.8188976377952756,49,78,52,75,39,13,10,65
7,44,0.06550802290439606,0.8188976377952756,49,78,52,75,39,13,10,65
7,45,0.05818833038210869,0.8188976377952756,49,78,52,75,39,13,10,65
7,46,0.06530658900737762,0.8031496062992126,47,80,52,75,37,15,10,65
7,47,0.08602432161569595,0.8031496062992126,49,78,52,75,38,14,11,64
7,48,0.055982742458581924,0.7874015748031497,51,76,52,75,38,14,13,62
7,49,0.06757939606904984,0.7874015748031497,51,76,52,75,38,14,13,62
8,0,1.0219062566757202,0.5905511811023622,0,127,52,75,0,52,0,75
8,1,7.431985855102539,0.5905511811023622,0,127,52,75,0,52,0,75
8,2,2.0319604873657227,0.5984251968503937,1,126,52,75,1,51,0,75
8,3,0.6896683573722839,0.4094488188976378,127,0,52,75,52,0,75,0
8,4,0.6920756697654724,0.4094488188976378,127,0,52,75,52,0,75,0
8,5,0.7391203045845032,0.4094488188976378,127,0,52,75,52,0,75,0
8,6,0.7597554922103882,0.4094488188976378,127,0,52,75,52,0,75,0
8,7,0.7460466623306274,0.4094488188976378,127,0,52,75,52,0,75,0
8,8,0.7169991135597229,0.41732283464566927,126,1,52,75,52,0,74,1
8,9,0.6724633574485779,0.4330708661417323,124,3,52,75,52,0,72,3
8,10,0.6471067667007446,0.5433070866141733,106,21,52,75,50,2,56,19
8,11,0.6146557927131653,0.5984251968503937,77,50,52,75,39,13,38,37
8,12,0.5797339081764221,0.6535433070866141,40,87,52,75,24,28,16,59
8,13,0.5688037872314453,0.6850393700787402,28,99,52,75,20,32,8,67
8,14,0.5675954818725586,0.6692913385826772,24,103,52,75,17,35,7,68
8,15,0.5447181463241577,0.6850393700787402,28,99,52,75,20,32,8,67
8,16,0.5221623182296753,0.7007874015748031,34,93,52,75,24,28,10,65
8,17,0.5086928606033325,0.6850393700787402,40,87,52,75,26,26,14,61
8,18,0.48721617460250854,0.6850393700787402,48,79,52,75,30,22,18,57
8,19,0.46635159850120544,0.6850393700787402,56,71,52,75,34,18,22,53
8,20,0.45884448289871216,0.7086614173228346,63,64,52,75,39,13,24,51
8,21,0.43985533714294434,0.7007874015748031,66,61,52,75,40,12,26,49
8,22,0.4198129177093506,0.7165354330708661,68,59,52,75,42,10,26,49
8,23,0.41073283553123474,0.7165354330708661,68,59,52,75,42,10,26,49
8,24,0.3826540410518646,0.7322834645669292,66,61,52,75,42,10,24,51
8,25,0.374798983335495,0.7244094488188977,67,60,52,75,42,10,25,50
8,26,0.3722705543041229,0.7086614173228346,67,60,52,75,41,11,26,49
8,27,0.3540714383125305,0.7007874015748031,66,61,52,75,40,12,26,49
8,28,0.3458927273750305,0.6929133858267716,67,60,52,75,40,12,27,48
8,29,0.3345790207386017,0.7165354330708661,64,63,52,75,40,12,24,51
8,30,0.3255443572998047,0.7086614173228346,65,62,52,75,40,12,25,50
8,31,0.3212749660015106,0.7086614173228346,65,62,52,75,40,12,25,50
8,32,0.28839173913002014,0.7086614173228346,65,62,52,75,40,12,25,50
8,33,0.29655879735946655,0.7165354330708661,64,63,52,75,40,12,24,51
8,34,0.29434946179389954,0.7086614173228346,63,64,52,75,39,13,24,51
8,35,0.2847089469432831,0.7086614173228346,63,64,52,75,39,13,24,51
8,36,0.26073357462882996,0.7165354330708661,62,65,52,75,39,13,23,52
8,37,0.2741374671459198,0.7165354330708661,60,67,52,75,38,14,22,53
8,38,0.2840023338794708,0.7165354330708661,60,67,52,75,38,14,22,53
8,39,0.2628771662712097,0.7244094488188977,57,70,52,75,37,15,20,55
8,40,0.2588634192943573,0.7244094488188977,57,70,52,75,37,15,20,55
8,41,0.25852513313293457,0.7244094488188977,57,70,52,75,37,15,20,55
8,42,0.25382736325263977,0.7244094488188977,57,70,52,75,37,15,20,55
8,43,0.24082177877426147,0.7165354330708661,58,69,52,75,37,15,21,54
8,44,0.24327310919761658,0.7165354330708661,58,69,52,75,37,15,21,54
8,45,0.24932260811328888,0.7165354330708661,58,69,52,75,37,15,21,54
8,46,0.2337370216846466,0.7244094488188977,57,70,52,75,37,15,20,55
8,47,0.23990517854690552,0.7322834645669292,56,71,52,75,37,15,19,56
8,48,0.24067440629005432,0.7322834645669292,56,71,52,75,37,15,19,56
8,49,0.22667479515075684,0.7322834645669292,56,71,52,75,37,15,19,56
9,0,0.7748846411705017,0.5905511811023622,0,127,52,75,0,52,0,75
9,1,9.11021614074707,0.5905511811023622,0,127,52,75,0,52,0,75
9,2,2.793884038925171,0.6850393700787402,84,43,52,75,48,4,36,39
9,3,0.6594358086585999,0.4094488188976378,127,0,52,75,52,0,75,0
9,4,0.8811640739440918,0.4094488188976378,127,0,52,75,52,0,75,0
9,5,0.915672779083252,0.4094488188976378,127,0,52,75,52,0,75,0
9,6,0.7835015654563904,0.4094488188976378,127,0,52,75,52,0,75,0
9,7,0.6920713782310486,0.4094488188976378,127,0,52,75,52,0,75,0
9,8,0.6813281774520874,0.41732283464566927,126,1,52,75,52,0,74,1
9,9,0.6340720057487488,0.4409448818897638,123,4,52,75,52,0,71,4
9,10,0.5818767547607422,0.5039370078740157,115,12,52,75,52,0,63,12
9,11,0.5575925707817078,0.6456692913385826,97,30,52,75,52,0,45,30
9,12,0.5283332467079163,0.7007874015748031,86,41,52,75,50,2,36,39
9,13,0.5227749943733215,0.7322834645669292,78,49,52,75,48,4,30,45
9,14,0.4968091547489166,0.7401574803149606,67,60,52,75,43,9,24,51
9,15,0.47398555278778076,0.8031496062992126,55,72,52,75,41,11,14,61
9,16,0.4476237893104553,0.8031496062992126,53,74,52,75,40,12,13,62
9,17,0.42142152786254883,0.8110236220472441,50,77,52,75,39,13,11,64
9,18,0.41333550214767456,0.8031496062992126,49,78,52,75,38,14,11,64
9,19,0.38106489181518555,0.8031496062992126,47,80,52,75,37,15,10,65
9,20,0.38226228952407837,0.7795275590551181,40,87,52,75,32,20,8,67
9,21,0.3539868891239166,0.7874015748031497,39,88,52,75,32,20,7,68
9,22,0.3467477560043335,0.7795275590551181,40,87,52,75,32,20,8,67
9,23,0.33266985416412354,0.8031496062992126,43,84,52,75,35,17,8,67
9,24,0.309049516916275,0.7952755905511811,44,83,52,75,35,17,9,66
9,25,0.29305902123451233,0.7952755905511811,48,79,52,75,37,15,11,64
9,26,0.2768361270427704,0.8110236220472441,48,79,52,75,38,14,10,65
9,27,0.26507502794265747,0.8188976377952756,47,80,52,75,38,14,9,66
9,28,0.25168314576148987,0.8267716535433071,48,79,52,75,39,13,9,66
9,29,0.2506648600101471,0.8110236220472441,50,77,52,75,39,13,11,64
9,30,0.23464998602867126,0.8110236220472441,50,77,52,75,39,13,11,64
9,31,0.21857039630413055,0.8110236220472441,50,77,52,75,39,13,11,64
9,32,0.204442098736763,0.8110236220472441,50,77,52,75,39,13,11,64
9,33,0.20813436806201935,0.8110236220472441,50,77,52,75,39,13,11,64
9,34,0.1944969892501831,0.7795275590551181,48,79,52,75,36,16,12,63
9,35,0.1795825958251953,0.7795275590551181,48,79,52,75,36,16,12,63
9,36,0.17222663760185242,0.7874015748031497,49,78,52,75,37,15,12,63
9,37,0.16424527764320374,0.7952755905511811,50,77,52,75,38,14,12,63
9,38,0.15491358935832977,0.7874015748031497,49,78,52,75,37,15,12,63
9,39,0.15575549006462097,0.7874015748031497,45,82,52,75,35,17,10,65
9,40,0.15662111341953278,0.7874015748031497,41,86,52,75,33,19,8,67
9,41,0.1672617793083191,0.7874015748031497,35,92,52,75,30,22,5,70
9,42,0.13670717179775238,0.7874015748031497,33,94,52,75,29,23,4,71
9,43,0.13377070426940918,0.7795275590551181,34,93,52,75,29,23,5,70
9,44,0.12672552466392517,0.7795275590551181,34,93,52,75,29,23,5,70
9,45,0.1286318451166153,0.7559055118110236,37,90,52,75,29,23,8,67
9,46,0.13680914044380188,0.7559055118110236,37,90,52,75,29,23,8,67
9,47,0.13218148052692413,0.7716535433070866,39,88,52,75,31,21,8,67
9,48,0.1488247513771057,0.7795275590551181,44,83,52,75,34,18,10,65
9,49,0.0982038825750351,0.7795275590551181,44,83,52,75,34,18,10,65
10,0,0.6937211155891418,0.5905511811023622,0,127,52,75,0,52,0,75
10,1,1.558685302734375,0.4094488188976378,127,0,52,75,52,0,75,0
10,2,7.5947346687316895,0.4094488188976378,127,0,52,75,52,0,75,0
10,3,3.488464593887329,0.4094488188976378,127,0,52,75,52,0,75,0
10,4,0.8834572434425354,0.7086614173228346,83,44,52,75,49,3,34,41
10,5,0.4048510491847992,0.7086614173228346,15,112,52,75,15,37,0,75
10,6,0.7277297377586365,0.5984251968503937,1,126,52,75,1,51,0,75
10,7,0.8663176894187927,0.5905511811023622,0,127,52,75,0,52,0,75
10,8,0.7581005096435547,0.5905511811023622,0,127,52,75,0,52,0,75
10,9,0.6325915455818176,0.8346456692913385,39,88,52,75,35,17,4,71
10,10,0.552532434463501,0.6692913385826772,86,41,52,75,48,4,38,37
10,11,0.5268774032592773,0.6535433070866141,94,33,52,75,51,1,43,32
10,12,0.49791571497917175,0.6614173228346457,91,36,52,75,50,2,41,34
10,13,0.4426979720592499,0.6771653543307087,87,40,52,75,49,3,38,37
10,14,0.3908718526363373,0.6929133858267716,85,42,52,75,49,3,36,39
10,15,0.3355560302734375,0.7480314960629921,78,49,52,75,49,3,29,46
10,16,0.3019505739212036,0.7716535433070866,71,56,52,75,47,5,24,51
10,17,0.27917611598968506,0.7952755905511811,64,63,52,75,45,7,19,56
10,18,0.2515735924243927,0.7952755905511811,62,65,52,75,44,8,18,57
10,19,0.2438603639602661,0.8110236220472441,60,67,52,75,44,8,16,59
10,20,0.2642076313495636,0.8110236220472441,62,65,52,75,45,7,17,58
10,21,0.20522955060005188,0.8346456692913385,61,66,52,75,46,6,15,60
10,22,0.2045906037092209,0.8031496062992126,65,62,52,75,46,6,19,56
10,23,0.1742546409368515,0.8267716535433071,66,61,52,75,48,4,18,57
10,24,0.1865905076265335,0.8110236220472441,64,63,52,75,46,6,18,57
10,25,0.1784074455499649,0.84251968503937,60,67,52,75,46,6,14,61
10,26,0.15896230936050415,0.8661417322834646,55,72,52,75,45,7,10,65
10,27,0.1364310383796692,0.8582677165354331,54,73,52,75,44,8,10,65
10,28,0.1384975016117096,0.8503937007874016,53,74,52,75,43,9,10,65
10,29,0.15120668709278107,0.8582677165354331,54,73,52,75,44,8,10,65
10,30,0.11758753657341003,0.8740157480314961,56,71,52,75,46,6,10,65
10,31,0.10434763133525848,0.8740157480314961,56,71,52,75,46,6,10,65
10,32,0.10384199023246765,0.8740157480314961,58,69,52,75,47,5,11,64
10,33,0.0974087119102478,0.8740157480314961,58,69,52,75,47,5,11,64
10,34,0.10008226335048676,0.8661417322834646,57,70,52,75,46,6,11,64
10,35,0.08046615123748779,0.8503937007874016,57,70,52,75,45,7,12,63
10,36,0.07439693063497543,0.8503937007874016,57,70,52,75,45,7,12,63
10,37,0.06997212022542953,0.8582677165354331,56,71,52,75,45,7,11,64
10,38,0.07532423734664917,0.84251968503937,54,73,52,75,43,9,11,64
10,39,0.09501555562019348,0.84251968503937,56,71,52,75,44,8,12,63
10,40,0.07607612013816833,0.84251968503937,58,69,52,75,45,7,13,62
10,41,0.0639304369688034,0.84251968503937,60,67,52,75,46,6,14,61
10,42,0.06280079483985901,0.8346456692913385,61,66,52,75,46,6,15,60
10,43,0.053683456033468246,0.8346456692913385,61,66,52,75,46,6,15,60
10,44,0.07761043310165405,0.8346456692913385,61,66,52,75,46,6,15,60
10,45,0.061061594635248184,0.8267716535433071,56,71,52,75,43,9,13,62
10,46,0.05768893286585808,0.84251968503937,54,73,52,75,43,9,11,64
10,47,0.05147236958146095,0.84251968503937,54,73,52,75,43,9,11,64
10,48,0.05223093181848526,0.8346456692913385,53,74,52,75,42,10,11,64
10,49,0.052595000714063644,0.84251968503937,54,73,52,75,43,9,11,64
11,0,0.7510790228843689,0.5905511811023622,0,127,52,75,0,52,0,75
11,1,8.550350189208984,0.5905511811023622,0,127,52,75,0,52,0,75
11,2,1.566288948059082,0.4566929133858268,115,12,52,75,49,3,66,9
11,3,0.6537782549858093,0.4094488188976378,127,0,52,75,52,0,75,0
11,4,0.7382541298866272,0.4094488188976378,127,0,52,75,52,0,75,0
11,5,0.787589430809021,0.4094488188976378,127,0,52,75,52,0,75,0
11,6,0.7618569135665894,0.4094488188976378,127,0,52,75,52,0,75,0
11,7,0.6935693025588989,0.4094488188976378,127,0,52,75,52,0,75,0
11,8,0.6512264609336853,0.48031496062992124,116,11,52,75,51,1,65,10
11,9,0.6232362389564514,0.6692913385826772,74,53,52,75,42,10,32,43
11,10,0.5677902698516846,0.6535433070866141,48,79,52,75,28,24,20,55
11,11,0.5362409949302673,0.6535433070866141,34,93,52,75,21,31,13,62
11,12,0.5079038143157959,0.6614173228346457,35,92,52,75,22,30,13,62
11,13,0.48156097531318665,0.6692913385826772,38,89,52,75,24,28,14,61
11,14,0.4822109043598175,0.6692913385826772,38,89,52,75,24,28,14,61
11,15,0.44639870524406433,0.6692913385826772,38,89,52,75,24,28,14,61
11,16,0.43751510977745056,0.7007874015748031,40,87,52,75,27,25,13,62
11,17,0.4032796025276184,0.7165354330708661,42,85,52,75,29,23,13,62
11,18,0.3855293393135071,0.7322834645669292,42,85,52,75,30,22,12,63
11,19,0.3666614592075348,0.7480314960629921,44,83,52,75,32,20,12,63
11,20,0.34678739309310913,0.7637795275590551,46,81,52,75,34,18,12,63
11,21,0.34828951954841614,0.7637795275590551,48,79,52,75,35,17,13,62
11,22,0.3219526410102844,0.7716535433070866,47,80,52,75,35,17,12,63
11,23,0.32189950346946716,0.7716535433070866,47,80,52,75,35,17,12,63
11,24,0.3070918619632721,0.7716535433070866,47,80,52,75,35,17,12,63
11,25,0.2909359931945801,0.7716535433070866,45,82,52,75,34,18,11,64
11,26,0.28753662109375,0.7795275590551181,46,81,52,75,35,17,11,64
11,27,0.2769887447357178,0.7795275590551181,46,81,52,75,35,17,11,64
11,28,0.26623770594596863,0.7716535433070866,45,82,52,75,34,18,11,64
11,29,0.2448282241821289,0.7637795275590551,46,81,52,75,34,18,12,63
11,30,0.2336357682943344,0.7637795275590551,48,79,52,75,35,17,13,62
11,31,0.22601990401744843,0.7637795275590551,48,79,52,75,35,17,13,62
11,32,0.21504473686218262,0.7637795275590551,50,77,52,75,36,16,14,61
11,33,0.2101418375968933,0.7716535433070866,51,76,52,75,37,15,14,61
11,34,0.19784674048423767,0.7795275590551181,50,77,52,75,37,15,13,62
11,35,0.19961205124855042,0.7795275590551181,52,75,52,75,38,14,14,61
11,36,0.19076092541217804,0.7716535433070866,49,78,52,75,36,16,13,62
11,37,0.17528332769870758,0.7716535433070866,49,78,52,75,36,16,13,62
11,38,0.17063429951667786,0.7716535433070866,49,78,52,75,36,16,13,62
11,39,0.17861030995845795,0.7716535433070866,49,78,52,75,36,16,13,62
11,40,0.1719835102558136,0.7795275590551181,50,77,52,75,37,15,13,62
11,41,0.1679602861404419,0.7795275590551181,50,77,52,75,37,15,13,62
11,42,0.15353652834892273,0.7795275590551181,50,77,52,75,37,15,13,62
11,43,0.14645729959011078,0.7716535433070866,49,78,52,75,36,16,13,62
11,44,0.13816317915916443,0.7795275590551181,50,77,52,75,37,15,13,62
11,45,0.11926611512899399,0.7795275590551181,50,77,52,75,37,15,13,62
11,46,0.1363542228937149,0.7795275590551181,50,77,52,75,37,15,13,62
11,47,0.12737536430358887,0.7637795275590551,48,79,52,75,35,17,13,62
11,48,0.13605038821697235,0.7559055118110236,45,82,52,75,33,19,12,63
11,49,0.11348928511142731,0.7559055118110236,43,84,52,75,32,20,11,64
12,0,1.1061391830444336,0.4094488188976378,127,0,52,75,52,0,75,0
12,1,7.783857822418213,0.4094488188976378,127,0,52,75,52,0,75,0
12,2,2.3816239833831787,0.48031496062992124,116,11,52,75,51,1,65,10
12,3,0.7103188037872314,0.5905511811023622,0,127,52,75,0,52,0,75
12,4,0.698582649230957,0.5905511811023622,0,127,52,75,0,52,0,75
12,5,0.7307214736938477,0.5905511811023622,0,127,52,75,0,52,0,75
12,6,0.7299310564994812,0.5905511811023622,0,127,52,75,0,52,0,75
12,7,0.6991456151008606,0.5905511811023622,0,127,52,75,0,52,0,75
12,8,0.6836050152778625,0.5905511811023622,0,127,52,75,0,52,0,75
12,9,0.677432119846344,0.5905511811023622,0,127,52,75,0,52,0,75
12,10,0.6485555768013,0.5905511811023622,0,127,52,75,0,52,0,75
12,11,0.6339731216430664,0.5905511811023622,0,127,52,75,0,52,0,75
12,12,0.6170171499252319,0.6141732283464567,3,124,52,75,3,49,0,75
12,13,0.5976446866989136,0.6456692913385826,7,120,52,75,7,45,0,75
12,14,0.5567867755889893,0.7086614173228346,17,110,52,75,16,36,1,74
12,15,0.5290572047233582,0.7322834645669292,38,89,52,75,28,24,10,65
12,16,0.5082151293754578,0.7480314960629921,54,73,52,75,37,15,17,58
12,17,0.49760857224464417,0.7401574803149606,63,64,52,75,41,11,22,53
12,18,0.47627630829811096,0.7244094488188977,67,60,52,75,42,10,25,50
12,19,0.46855783462524414,0.7086614173228346,71,56,52,75,43,9,28,47
12,20,0.43673816323280334,0.7086614173228346,73,54,52,75,44,8,29,46
12,21,0.4357677698135376,0.7086614173228346,77,50,52,75,46,6,31,44
12,22,0.41110655665397644,0.7165354330708661,76,51,52,75,46,6,30,45
12,23,0.3855770528316498,0.7244094488188977,69,58,52,75,43,9,26,49
12,24,0.37729889154434204,0.7401574803149606,65,62,52,75,42,10,23,52
12,25,0.36189907789230347,0.7401574803149606,63,64,52,75,41,11,22,53
12,26,0.34511736035346985,0.7480314960629921,62,65,52,75,41,11,21,54
12,27,0.33843278884887695,0.7401574803149606,63,64,52,75,41,11,22,53
12,28,0.32948386669158936,0.7401574803149606,63,64,52,75,41,11,22,53
12,29,0.3112485408782959,0.7401574803149606,65,62,52,75,42,10,23,52
12,30,0.3036969304084778,0.7480314960629921,68,59,52,75,44,8,24,51
12,31,0.29306456446647644,0.7401574803149606,69,58,52,75,44,8,25,50
12,32,0.27517226338386536,0.7401574803149606,69,58,52,75,44,8,25,50
12,33,0.2552841305732727,0.7480314960629921,68,59,52,75,44,8,24,51
12,34,0.2572691738605499,0.7401574803149606,67,60,52,75,43,9,24,51
12,35,0.24903470277786255,0.7401574803149606,65,62,52,75,42,10,23,52
12,36,0.23875874280929565,0.7244094488188977,65,62,52,75,41,11,24,51
12,37,0.22155886888504028,0.7401574803149606,63,64,52,75,41,11,22,53
12,38,0.22635409235954285,0.7401574803149606,63,64,52,75,41,11,22,53
12,39,0.21271038055419922,0.7401574803149606,61,66,52,75,40,12,21,54
12,40,0.21404695510864258,0.7480314960629921,60,67,52,75,40,12,20,55
12,41,0.1971975862979889,0.7480314960629921,58,69,52,75,39,13,19,56
12,42,0.20449580252170563,0.7480314960629921,58,69,52,75,39,13,19,56
12,43,0.19490596652030945,0.7322834645669292,60,67,52,75,39,13,21,54
12,44,0.18296930193901062,0.7401574803149606,63,64,52,75,41,11,22,53
12,45,0.178059384226799,0.7559055118110236,63,64,52,75,42,10,21,54
12,46,0.1752377450466156,0.7401574803149606,69,58,52,75,44,8,25,50
12,47,0.1633746325969696,0.7322834645669292,72,55,52,75,45,7,27,48
12,48,0.17203062772750854,0.7322834645669292,72,55,52,75,45,7,27,48
12,49,0.15818345546722412,0.7401574803149606,71,56,52,75,45,7,26,49
13,0,0.8555011749267578,0.4094488188976378,127,0,52,75,52,0,75,0
13,1,8.183075904846191,0.4094488188976378,127,0,52,75,52,0,75,0
13,2,2.308448076248169,0.4094488188976378,127,0,52,75,52,0,75,0
13,3,0.6771689653396606,0.5905511811023622,0,127,52,75,0,52,0,75
13,4,0.729761004447937,0.5905511811023622,0,127,52,75,0,52,0,75
13,5,0.7672361731529236,0.5905511811023622,0,127,52,75,0,52,0,75
13,6,0.7433671355247498,0.5905511811023622,0,127,52,75,0,52,0,75
13,7,0.702957272529602,0.5905511811023622,0,127,52,75,0,52,0,75
13,8,0.6825175881385803,0.5905511811023622,0,127,52,75,0,52,0,75
13,9,0.6733866930007935,0.5905511811023622,0,127,52,75,0,52,0,75
13,10,0.6662642359733582,0.5905511811023622,0,127,52,75,0,52,0,75
13,11,0.6439310312271118,0.5984251968503937,1,126,52,75,1,51,0,75
13,12,0.6225599646568298,0.6299212598425197,5,122,52,75,5,47,0,75
13,13,0.5942437648773193,0.6850393700787402,32,95,52,75,22,30,10,65
13,14,0.5527283549308777,0.6377952755905512,62,65,52,75,34,18,28,47
13,15,0.5303089618682861,0.6535433070866141,84,43,52,75,46,6,38,37
13,16,0.5042275190353394,0.6220472440944882,90,37,52,75,47,5,43,32
13,17,0.47613900899887085,0.5984251968503937,95,32,52,75,48,4,47,28
13,18,0.45412877202033997,0.5748031496062992,96,31,52,75,47,5,49,26
13,19,0.4321731626987457,0.5669291338582677,97,30,52,75,47,5,50,25
13,20,0.4140596389770508,0.5748031496062992,96,31,52,75,47,5,49,26
13,21,0.39370235800743103,0.5748031496062992,96,31,52,75,47,5,49,26
13,22,0.37958765029907227,0.5905511811023622,94,33,52,75,47,5,47,28
13,23,0.364224910736084,0.6141732283464567,89,38,52,75,46,6,43,32
13,24,0.3392360508441925,0.6220472440944882,82,45,52,75,43,9,39,36
13,25,0.32434511184692383,0.6850393700787402,72,55,52,75,42,10,30,45
13,26,0.3133205771446228,0.7086614173228346,69,58,52,75,42,10,27,48
13,27,0.298667311668396,0.7007874015748031,66,61,52,75,40,12,26,49
13,28,0.2798863649368286,0.7007874015748031,68,59,52,75,41,11,27,48
13,29,0.26954954862594604,0.6929133858267716,69,58,52,75,41,11,28,47
13,30,0.2606761157512665,0.6929133858267716,71,56,52,75,42,10,29,46
13,31,0.247639000415802,0.6929133858267716,71,56,52,75,42,10,29,46
13,32,0.23238231241703033,0.7007874015748031,72,55,52,75,43,9,29,46
13,33,0.22257556021213531,0.6929133858267716,73,54,52,75,43,9,30,45
13,34,0.23134642839431763,0.6929133858267716,73,54,52,75,43,9,30,45
13,35,0.21601392328739166,0.7007874015748031,72,55,52,75,43,9,29,46
13,36,0.21044117212295532,0.7007874015748031,70,57,52,75,42,10,28,47
13,37,0.1994958370923996,0.7086614173228346,69,58,52,75,42,10,27,48
13,38,0.19528721272945404,0.6929133858267716,67,60,52,75,40,12,27,48
13,39,0.18862758576869965,0.7086614173228346,65,62,52,75,40,12,25,50
13,40,0.18655778467655182,0.7007874015748031,62,65,52,75,38,14,24,51
13,41,0.1731644570827484,0.7086614173228346,61,66,52,75,38,14,23,52
13,42,0.1738315224647522,0.7165354330708661,62,65,52,75,39,13,23,52
13,43,0.1629379391670227,0.7165354330708661,64,63,52,75,40,12,24,51
13,44,0.16875684261322021,0.7244094488188977,63,64,52,75,40,12,23,52
13,45,0.16131198406219482,0.7244094488188977,65,62,52,75,41,11,24,51
13,46,0.1418999582529068,0.7244094488188977,65,62,52,75,41,11,24,51
13,47,0.15517979860305786,0.7244094488188977,65,62,52,75,41,11,24,51
13,48,0.15600287914276123,0.7322834645669292,68,59,52,75,43,9,25,50
13,49,0.15429134666919708,0.7244094488188977,67,60,52,75,42,10,25,50
14,0,0.7252435684204102,0.41732283464566927,127,0,53,74,53,0,74,0
14,1,9.027826309204102,0.41732283464566927,127,0,53,74,53,0,74,0
14,2,1.499216914176941,0.3464566929133858,54,73,53,74,12,41,42,32
14,3,0.6942238807678223,0.5826771653543307,0,127,53,74,0,53,0,74
14,4,0.8580045104026794,0.5826771653543307,0,127,53,74,0,53,0,74
14,5,0.8600874543190002,0.5826771653543307,0,127,53,74,0,53,0,74
14,6,0.7989791035652161,0.5826771653543307,0,127,53,74,0,53,0,74
14,7,0.7420941591262817,0.5826771653543307,0,127,53,74,0,53,0,74
14,8,0.7139952182769775,0.5826771653543307,0,127,53,74,0,53,0,74
14,9,0.7000935673713684,0.5826771653543307,0,127,53,74,0,53,0,74
14,10,0.6916876435279846,0.5905511811023622,1,126,53,74,1,52,0,74
14,11,0.6837261319160461,0.6456692913385826,18,109,53,74,13,40,5,69
14,12,0.6692823171615601,0.6535433070866141,59,68,53,74,34,19,25,49
14,13,0.6554844379425049,0.5826771653543307,88,39,53,74,44,9,44,30
14,14,0.6315041184425354,0.5196850393700787,102,25,53,74,47,6,55,19
14,15,0.6311634182929993,0.5039370078740157,108,19,53,74,49,4,59,15
14,16,0.6146270036697388,0.5196850393700787,104,23,53,74,48,5,56,18
14,17,0.5782230496406555,0.5748031496062992,95,32,53,74,47,6,48,26
14,18,0.5716054439544678,0.6456692913385826,84,43,53,74,46,7,38,36
14,19,0.5429081320762634,0.7165354330708661,73,54,53,74,45,8,28,46
14,20,0.47819408774375916,0.7165354330708661,67,60,53,74,42,11,25,49
14,21,0.46203458309173584,0.7480314960629921,61,66,53,74,41,12,20,54
14,22,0.44233983755111694,0.7559055118110236,62,65,53,74,42,11,20,54
14,23,0.38458892703056335,0.7637795275590551,63,64,53,74,43,10,20,54
14,24,0.35386747121810913,0.7637795275590551,67,60,53,74,45,8,22,52
14,25,0.3792148232460022,0.7716535433070866,68,59,53,74,46,7,22,52
14,26,0.359788715839386,0.7637795275590551,67,60,53,74,45,8,22,52
14,27,0.3404635190963745,0.7795275590551181,63,64,53,74,44,9,19,55
14,28,0.313847154378891,0.7795275590551181,57,70,53,74,41,12,16,58
14,29,0.2991059720516205,0.7795275590551181,53,74,53,74,39,14,14,60
14,30,0.3106192946434021,0.7952755905511811,49,78,53,74,38,15,11,63
14,31,0.29703786969184875,0.8031496062992126,50,77,53,74,39,14,11,63
14,32,0.29003068804740906,0.7874015748031497,52,75,53,74,39,14,13,61
14,33,0.26659074425697327,0.7795275590551181,51,76,53,74,38,15,13,61
14,34,0.25544553995132446,0.7716535433070866,50,77,53,74,37,16,13,61
14,35,0.2496372014284134,0.7637795275590551,49,78,53,74,36,17,13,61
14,36,0.2422945648431778,0.7637795275590551,47,80,53,74,35,18,12,62
14,37,0.2345360666513443,0.7637795275590551,47,80,53,74,35,18,12,62
14,38,0.2208014726638794,0.7637795275590551,49,78,53,74,36,17,13,61
14,39,0.2315385788679123,0.7795275590551181,51,76,53,74,38,15,13,61
14,40,0.22727200388908386,0.7795275590551181,51,76,53,74,38,15,13,61
14,41,0.2063380479812622,0.7716535433070866,54,73,53,74,39,14,15,59
14,42,0.1867164522409439,0.7716535433070866,54,73,53,74,39,14,15,59
14,43,0.20469026267528534,0.7874015748031497,52,75,53,74,39,14,13,61
14,44,0.18126922845840454,0.8031496062992126,48,79,53,74,38,15,10,64
14,45,0.18820317089557648,0.8031496062992126,48,79,53,74,38,15,10,64
14,46,0.19766761362552643,0.8110236220472441,49,78,53,74,39,14,10,64
14,47,0.16713951528072357,0.8188976377952756,48,79,53,74,39,14,9,65
14,48,0.17490829527378082,0.8031496062992126,50,77,53,74,39,14,11,63
14,49,0.19425980746746063,0.8110236220472441,47,80,53,74,38,15,9,65
15,0,0.7324284315109253,0.41732283464566927,127,0,53,74,53,0,74,0
15,1,8.918402671813965,0.41732283464566927,127,0,53,74,53,0,74,0
15,2,2.4040777683258057,0.41732283464566927,127,0,53,74,53,0,74,0
15,3,0.6453535556793213,0.5826771653543307,0,127,53,74,0,53,0,74
15,4,0.9435301423072815,0.5826771653543307,0,127,53,74,0,53,0,74
15,5,0.9054755568504333,0.5669291338582677,2,125,53,74,0,53,2,72
15,6,0.7617253661155701,0.5826771653543307,10,117,53,74,5,48,5,69
15,7,0.6801069974899292,0.6141732283464567,30,97,53,74,17,36,13,61
15,8,0.6341388821601868,0.6692913385826772,39,88,53,74,25,28,14,60
15,9,0.6067950129508972,0.7007874015748031,41,86,53,74,28,25,13,61
15,10,0.5812135338783264,0.7165354330708661,37,90,53,74,27,26,10,64
15,11,0.5430362820625305,0.7244094488188977,30,97,53,74,24,29,6,68
15,12,0.5002787113189697,0.6929133858267716,22,105,53,74,18,35,4,70
15,13,0.45898768305778503,0.6535433070866141,15,112,53,74,12,41,3,71
15,14,0.4336877763271332,0.6299212598425197,8,119,53,74,7,46,1,73
15,15,0.3855133354663849,0.5826771653543307,0,127,53,74,0,53,0,74
15,16,0.3956015110015869,0.5826771653543307,0,127,53,74,0,53,0,74
15,17,0.33881905674934387,0.5826771653543307,0,127,53,74,0,53,0,74
15,18,0.2850012481212616,0.5826771653543307,0,127,53,74,0,53,0,74
15,19,0.2730790674686432,0.5826771653543307,0,127,53,74,0,53,0,74
15,20,0.24279898405075073,0.5826771653543307,0,127,53,74,0,53,0,74
15,21,0.23538890480995178,0.5826771653543307,0,127,53,74,0,53,0,74
15,22,0.24340705573558807,0.6299212598425197,6,121,53,74,6,47,0,74
15,23,0.20053768157958984,0.6456692913385826,8,119,53,74,8,45,0,74
15,24,0.19022850692272186,0.6692913385826772,11,116,53,74,11,42,0,74
15,25,0.18134039640426636,0.7165354330708661,19,108,53,74,18,35,1,73
15,26,0.20406195521354675,0.7480314960629921,23,104,53,74,22,31,1,73
15,27,0.15359587967395782,0.7401574803149606,24,103,53,74,22,31,2,72
15,28,0.17166876792907715,0.7401574803149606,24,103,53,74,22,31,2,72
15,29,0.15098242461681366,0.7480314960629921,27,100,53,74,24,29,3,71
15,30,0.12767258286476135,0.7637795275590551,31,96,53,74,27,26,4,70
15,31,0.1281825602054596,0.7795275590551181,33,94,53,74,29,24,4,70
15,32,0.10301735252141953,0.7795275590551181,33,94,53,74,29,24,4,70
15,33,0.12192877382040024,0.7874015748031497,34,93,53,74,30,23,4,70
15,34,0.09811091423034668,0.7952755905511811,35,92,53,74,31,22,4,70
15,35,0.09284980595111847,0.7952755905511811,35,92,53,74,31,22,4,70
15,36,0.10638637095689774,0.8110236220472441,37,90,53,74,33,20,4,70
15,37,0.09260325133800507,0.8188976377952756,38,89,53,74,34,19,4,70
15,38,0.10359480232000351,0.8267716535433071,39,88,53,74,35,18,4,70
15,39,0.08612705767154694,0.8346456692913385,42,85,53,74,37,16,5,69
15,40,0.08936861157417297,0.8503937007874016,44,83,53,74,39,14,5,69
15,41,0.07479314506053925,0.8503937007874016,44,83,53,74,39,14,5,69
15,42,0.10971024632453918,0.8503937007874016,42,85,53,74,38,15,4,70
15,43,0.0786132737994194,0.8346456692913385,40,87,53,74,36,17,4,70
15,44,0.06798417121171951,0.8110236220472441,37,90,53,74,33,20,4,70
15,45,0.07340743392705917,0.8110236220472441,37,90,53,74,33,20,4,70
15,46,0.06778213381767273,0.8110236220472441,37,90,53,74,33,20,4,70
15,47,0.08458212018013,0.8031496062992126,36,91,53,74,32,21,4,70
15,48,0.06166855990886688,0.8031496062992126,36,91,53,74,32,21,4,70
15,49,0.065931037068367,0.8110236220472441,37,90,53,74,33,20,4,70
