Fold,Epoch,Loss,Accuracy,Pred_Real,Pred_Fake,True_Real,True_Fake,TN,FP,FN,TP
1,0,0.7033203840255737,0.4140625,128,0,53,75,53,0,75,0
1,1,3.194597005844116,0.4140625,128,0,53,75,53,0,75,0
1,2,0.915657103061676,0.5859375,0,128,53,75,0,53,0,75
1,3,0.7089536190032959,0.5859375,0,128,53,75,0,53,0,75
1,4,0.8908023834228516,0.5859375,0,128,53,75,0,53,0,75
1,5,0.8534721732139587,0.5859375,0,128,53,75,0,53,0,75
1,6,0.7637312412261963,0.5859375,0,128,53,75,0,53,0,75
1,7,0.7198966145515442,0.5859375,0,128,53,75,0,53,0,75
1,8,0.6910489797592163,0.5859375,0,128,53,75,0,53,0,75
1,9,0.6807456612586975,0.5859375,0,128,53,75,0,53,0,75
1,10,0.6724801659584045,0.5859375,0,128,53,75,0,53,0,75
1,11,0.6566095948219299,0.5859375,0,128,53,75,0,53,0,75
1,12,0.6295942068099976,0.5859375,0,128,53,75,0,53,0,75
1,13,0.6162828207015991,0.6015625,14,114,53,75,8,45,6,69
1,14,0.5954009294509888,0.640625,23,105,53,75,15,38,8,67
1,15,0.5737530589103699,0.6484375,26,102,53,75,17,36,9,66
1,16,0.5415784120559692,0.640625,29,99,53,75,18,35,11,64
1,17,0.5214108228683472,0.6640625,36,92,53,75,23,30,13,62
1,18,0.4965120553970337,0.671875,37,91,53,75,24,29,13,62
1,19,0.4709421694278717,0.671875,37,91,53,75,24,29,13,62
1,20,0.44904354214668274,0.6875,39,89,53,75,26,27,13,62
1,21,0.42756715416908264,0.6875,41,87,53,75,27,26,14,61
1,22,0.4120235741138458,0.6953125,44,84,53,75,29,24,15,60
1,23,0.3653479516506195,0.6796875,44,84,53,75,28,25,16,59
1,24,0.33006197214126587,0.7109375,50,78,53,75,33,20,17,58
1,25,0.2963545620441437,0.7109375,50,78,53,75,33,20,17,58
1,26,0.28167176246643066,0.7109375,50,78,53,75,33,20,17,58
1,27,0.25654953718185425,0.7109375,46,82,53,75,31,22,15,60
1,28,0.27487924695014954,0.75,53,75,53,75,37,16,16,59
1,29,0.2424851506948471,0.75,55,73,53,75,38,15,17,58
1,30,0.22875775396823883,0.7421875,50,78,53,75,35,18,15,60
1,31,0.1850435435771942,0.75,49,79,53,75,35,18,14,61
1,32,0.16566789150238037,0.75,51,77,53,75,36,17,15,60
1,33,0.16416476666927338,0.7421875,46,82,53,75,33,20,13,62
1,34,0.15194591879844666,0.75,45,83,53,75,33,20,12,63
1,35,0.15315601229667664,0.7421875,42,86,53,75,31,22,11,64
1,36,0.12280318886041641,0.75,41,87,53,75,31,22,10,65
1,37,0.1249237209558487,0.75,49,79,53,75,35,18,14,61
1,38,0.10988911241292953,0.75,55,73,53,75,38,15,17,58
1,39,0.12650619447231293,0.75,49,79,53,75,35,18,14,61
1,40,0.10621222108602524,0.75,41,87,53,75,31,22,10,65
1,41,0.09239545464515686,0.7265625,38,90,53,75,28,25,10,65
1,42,0.09988496452569962,0.7421875,40,88,53,75,30,23,10,65
1,43,0.08577705174684525,0.7421875,46,82,53,75,33,20,13,62
1,44,0.08000600337982178,0.75,51,77,53,75,36,17,15,60
1,45,0.06953591853380203,0.7421875,50,78,53,75,35,18,15,60
1,46,0.06317341327667236,0.7421875,48,80,53,75,34,19,14,61
1,47,0.06945648044347763,0.7265625,44,84,53,75,31,22,13,62
1,48,0.05848952755331993,0.734375,41,87,53,75,30,23,11,64
1,49,0.06003862991929054,0.7265625,40,88,53,75,29,24,11,64
2,0,0.7224643230438232,0.5905511811023622,0,127,52,75,0,52,0,75
2,1,3.372441530227661,0.5905511811023622,0,127,52,75,0,52,0,75
2,2,0.9363564252853394,0.5669291338582677,107,20,52,75,52,0,55,20
2,3,0.6758365631103516,0.4094488188976378,127,0,52,75,52,0,75,0
2,4,0.8098336458206177,0.4094488188976378,127,0,52,75,52,0,75,0
2,5,0.7994162440299988,0.4094488188976378,127,0,52,75,52,0,75,0
2,6,0.7589414715766907,0.4094488188976378,127,0,52,75,52,0,75,0
2,7,0.7253579497337341,0.4094488188976378,127,0,52,75,52,0,75,0
2,8,0.715967059135437,0.4094488188976378,127,0,52,75,52,0,75,0
2,9,0.710411012172699,0.4094488188976378,127,0,52,75,52,0,75,0
2,10,0.7059999704360962,0.4094488188976378,127,0,52,75,52,0,75,0
2,11,0.7023186087608337,0.4094488188976378,127,0,52,75,52,0,75,0
2,12,0.6979512572288513,0.4094488188976378,127,0,52,75,52,0,75,0
2,13,0.6947343945503235,0.4094488188976378,127,0,52,75,52,0,75,0
2,14,0.689235508441925,0.4094488188976378,127,0,52,75,52,0,75,0
2,15,0.6834646463394165,0.4094488188976378,127,0,52,75,52,0,75,0
2,16,0.6770636439323425,0.4094488188976378,127,0,52,75,52,0,75,0
2,17,0.6644845008850098,0.4881889763779528,111,16,52,75,49,3,62,13
2,18,0.650561511516571,0.5354330708661418,99,28,52,75,46,6,53,22
2,19,0.6304372549057007,0.5669291338582677,95,32,52,75,46,6,49,26
2,20,0.6120415329933167,0.5748031496062992,94,33,52,75,46,6,48,27
2,21,0.5894033908843994,0.5748031496062992,96,31,52,75,47,5,49,26
2,22,0.5598785877227783,0.5669291338582677,97,30,52,75,47,5,50,25
2,23,0.5410277843475342,0.5590551181102362,98,29,52,75,47,5,51,24
2,24,0.5091323852539062,0.5590551181102362,98,29,52,75,47,5,51,24
2,25,0.49279171228408813,0.5590551181102362,98,29,52,75,47,5,51,24
2,26,0.4642690122127533,0.5905511811023622,94,33,52,75,47,5,47,28
2,27,0.4396766126155853,0.6220472440944882,90,37,52,75,47,5,43,32
2,28,0.4275711476802826,0.6299212598425197,89,38,52,75,47,5,42,33
2,29,0.4075148403644562,0.6535433070866141,86,41,52,75,47,5,39,36
2,30,0.38778260350227356,0.6850393700787402,82,45,52,75,47,5,35,40
2,31,0.3636929392814636,0.7007874015748031,78,49,52,75,46,6,32,43
2,32,0.3489641547203064,0.7086614173228346,75,52,52,75,45,7,30,45
2,33,0.33473116159439087,0.7322834645669292,72,55,52,75,45,7,27,48
2,34,0.3193986415863037,0.7322834645669292,70,57,52,75,44,8,26,49
2,35,0.2984107732772827,0.7401574803149606,67,60,52,75,43,9,24,51
2,36,0.28106752038002014,0.7559055118110236,63,64,52,75,42,10,21,54
2,37,0.266978919506073,0.7637795275590551,62,65,52,75,42,10,20,55
2,38,0.25687408447265625,0.7559055118110236,63,64,52,75,42,10,21,54
2,39,0.2466108500957489,0.7559055118110236,63,64,52,75,42,10,21,54
2,40,0.2371276170015335,0.7559055118110236,63,64,52,75,42,10,21,54
2,41,0.22447672486305237,0.7480314960629921,60,67,52,75,40,12,20,55
2,42,0.23083418607711792,0.7401574803149606,61,66,52,75,40,12,21,54
2,43,0.21292400360107422,0.7401574803149606,61,66,52,75,40,12,21,54
2,44,0.20261405408382416,0.7401574803149606,63,64,52,75,41,11,22,53
2,45,0.19406753778457642,0.7480314960629921,62,65,52,75,41,11,21,54
2,46,0.20120444893836975,0.7480314960629921,62,65,52,75,41,11,21,54
2,47,0.1882784217596054,0.7480314960629921,60,67,52,75,40,12,20,55
2,48,0.18756987154483795,0.7559055118110236,59,68,52,75,40,12,19,56
2,49,0.174531951546669,0.7480314960629921,60,67,52,75,40,12,20,55
3,0,0.693286120891571,0.4094488188976378,127,0,52,75,52,0,75,0
3,1,3.8154003620147705,0.4094488188976378,127,0,52,75,52,0,75,0
3,2,0.8582559823989868,0.5905511811023622,0,127,52,75,0,52,0,75
3,3,0.7072111368179321,0.5905511811023622,0,127,52,75,0,52,0,75
3,4,0.9343294501304626,0.5905511811023622,0,127,52,75,0,52,0,75
3,5,0.8654378652572632,0.5905511811023622,0,127,52,75,0,52,0,75
3,6,0.7657623887062073,0.5905511811023622,0,127,52,75,0,52,0,75
3,7,0.7020300030708313,0.5905511811023622,0,127,52,75,0,52,0,75
3,8,0.6663540005683899,0.5905511811023622,0,127,52,75,0,52,0,75
3,9,0.6436420679092407,0.5905511811023622,0,127,52,75,0,52,0,75
3,10,0.6227366924285889,0.5905511811023622,0,127,52,75,0,52,0,75
3,11,0.5984930396080017,0.6062992125984252,2,125,52,75,2,50,0,75
3,12,0.5836522579193115,0.7401574803149606,49,78,52,75,34,18,15,60
3,13,0.5535039305686951,0.7559055118110236,65,62,52,75,43,9,22,53
3,14,0.5400049686431885,0.7559055118110236,67,60,52,75,44,8,23,52
3,15,0.5137956738471985,0.7795275590551181,60,67,52,75,42,10,18,57
3,16,0.4898579716682434,0.7716535433070866,55,72,52,75,39,13,16,59
3,17,0.47524747252464294,0.7716535433070866,55,72,52,75,39,13,16,59
3,18,0.4636032283306122,0.7952755905511811,64,63,52,75,45,7,19,56
3,19,0.4256404936313629,0.8110236220472441,66,61,52,75,47,5,19,56
3,20,0.4201597273349762,0.7952755905511811,60,67,52,75,43,9,17,58
3,21,0.38936281204223633,0.8031496062992126,53,74,52,75,40,12,13,62
3,22,0.3735775351524353,0.8031496062992126,51,76,52,75,39,13,12,63
3,23,0.3620541989803314,0.8110236220472441,50,77,52,75,39,13,11,64
3,24,0.34920215606689453,0.8188976377952756,53,74,52,75,41,11,12,63
3,25,0.3308447003364563,0.8188976377952756,57,70,52,75,43,9,14,61
3,26,0.322048544883728,0.8346456692913385,55,72,52,75,43,9,12,63
3,27,0.3154653310775757,0.8267716535433071,52,75,52,75,41,11,11,64
3,28,0.2924050986766815,0.8031496062992126,45,82,52,75,36,16,9,66
3,29,0.28589928150177,0.8031496062992126,43,84,52,75,35,17,8,67
3,30,0.2878251373767853,0.7952755905511811,44,83,52,75,35,17,9,66
3,31,0.2674785852432251,0.8031496062992126,45,82,52,75,36,16,9,66
3,32,0.2661226689815521,0.8267716535433071,48,79,52,75,39,13,9,66
3,33,0.25535666942596436,0.84251968503937,50,77,52,75,41,11,9,66
3,34,0.25229573249816895,0.84251968503937,50,77,52,75,41,11,9,66
3,35,0.23551051318645477,0.8346456692913385,49,78,52,75,40,12,9,66
3,36,0.22658401727676392,0.8188976377952756,47,80,52,75,38,14,9,66
3,37,0.2328166365623474,0.8267716535433071,48,79,52,75,39,13,9,66
3,38,0.23180930316448212,0.84251968503937,50,77,52,75,41,11,9,66
3,39,0.2120346575975418,0.8503937007874016,53,74,52,75,43,9,10,65
3,40,0.2069757580757141,0.8582677165354331,54,73,52,75,44,8,10,65
3,41,0.21950525045394897,0.8582677165354331,52,75,52,75,43,9,9,66
3,42,0.19424043595790863,0.8267716535433071,48,79,52,75,39,13,9,66
3,43,0.19606828689575195,0.8267716535433071,48,79,52,75,39,13,9,66
3,44,0.187879741191864,0.8503937007874016,51,76,52,75,42,10,9,66
3,45,0.1841401904821396,0.8582677165354331,52,75,52,75,43,9,9,66
3,46,0.1826697289943695,0.8740157480314961,54,73,52,75,45,7,9,66
3,47,0.18025930225849152,0.8582677165354331,52,75,52,75,43,9,9,66
3,48,0.1656634509563446,0.8503937007874016,49,78,52,75,41,11,8,67
3,49,0.1663353145122528,0.8503937007874016,49,78,52,75,41,11,8,67
4,0,0.7634215950965881,0.5905511811023622,0,127,52,75,0,52,0,75
4,1,3.235988140106201,0.5905511811023622,0,127,52,75,0,52,0,75
4,2,0.8921850323677063,0.5196850393700787,111,16,52,75,51,1,60,15
4,3,0.6660492420196533,0.4094488188976378,127,0,52,75,52,0,75,0
4,4,0.7273291349411011,0.4094488188976378,127,0,52,75,52,0,75,0
4,5,0.765762209892273,0.4094488188976378,127,0,52,75,52,0,75,0
4,6,0.7658635973930359,0.4094488188976378,127,0,52,75,52,0,75,0
4,7,0.7503914833068848,0.4094488188976378,127,0,52,75,52,0,75,0
4,8,0.7338212728500366,0.4094488188976378,127,0,52,75,52,0,75,0
4,9,0.721824586391449,0.4094488188976378,127,0,52,75,52,0,75,0
4,10,0.709773600101471,0.4094488188976378,127,0,52,75,52,0,75,0
4,11,0.6906529068946838,0.4251968503937008,125,2,52,75,52,0,73,2
4,12,0.6733465790748596,0.5748031496062992,100,27,52,75,49,3,51,24
4,13,0.6599776148796082,0.7244094488188977,67,60,52,75,42,10,25,50
4,14,0.6543917059898376,0.7795275590551181,54,73,52,75,39,13,15,60
4,15,0.6276585459709167,0.7795275590551181,50,77,52,75,37,15,13,62
4,16,0.6069532632827759,0.7322834645669292,40,87,52,75,29,23,11,64
4,17,0.5929009318351746,0.6614173228346457,25,102,52,75,17,35,8,67
4,18,0.5823495388031006,0.6535433070866141,18,109,52,75,13,39,5,70
4,19,0.5575443506240845,0.6220472440944882,14,113,52,75,9,43,5,70
4,20,0.5360113382339478,0.6220472440944882,14,113,52,75,9,43,5,70
4,21,0.5199771523475647,0.6220472440944882,14,113,52,75,9,43,5,70
4,22,0.5096708536148071,0.6535433070866141,18,109,52,75,13,39,5,70
4,23,0.48611682653427124,0.6850393700787402,22,105,52,75,17,35,5,70
4,24,0.4594726264476776,0.6771653543307087,27,100,52,75,19,33,8,67
4,25,0.4399016201496124,0.7086614173228346,31,96,52,75,23,29,8,67
4,26,0.4300454258918762,0.7244094488188977,33,94,52,75,25,27,8,67
4,27,0.41579046845436096,0.7165354330708661,38,89,52,75,27,25,11,64
4,28,0.3836486339569092,0.7244094488188977,39,88,52,75,28,24,11,64
4,29,0.37331557273864746,0.7322834645669292,40,87,52,75,29,23,11,64
4,30,0.3580198287963867,0.7480314960629921,44,83,52,75,32,20,12,63
4,31,0.3332754671573639,0.7637795275590551,48,79,52,75,35,17,13,62
4,32,0.320841521024704,0.7716535433070866,49,78,52,75,36,16,13,62
4,33,0.301765501499176,0.7952755905511811,52,75,52,75,39,13,13,62
4,34,0.2961827516555786,0.8031496062992126,53,74,52,75,40,12,13,62
4,35,0.28776484727859497,0.7874015748031497,55,72,52,75,40,12,15,60
4,36,0.272531121969223,0.7952755905511811,54,73,52,75,40,12,14,61
4,37,0.2714334726333618,0.7874015748031497,53,74,52,75,39,13,14,61
4,38,0.25994518399238586,0.7874015748031497,53,74,52,75,39,13,14,61
4,39,0.2427389770746231,0.7874015748031497,49,78,52,75,37,15,12,63
4,40,0.24001069366931915,0.7874015748031497,49,78,52,75,37,15,12,63
4,41,0.21422825753688812,0.7874015748031497,49,78,52,75,37,15,12,63
4,42,0.22835782170295715,0.7874015748031497,49,78,52,75,37,15,12,63
4,43,0.20407898724079132,0.7952755905511811,50,77,52,75,38,14,12,63
4,44,0.20717881619930267,0.8031496062992126,49,78,52,75,38,14,11,64
4,45,0.20809246599674225,0.8031496062992126,49,78,52,75,38,14,11,64
4,46,0.19281187653541565,0.8031496062992126,49,78,52,75,38,14,11,64
4,47,0.19232434034347534,0.8110236220472441,50,77,52,75,39,13,11,64
4,48,0.1806272715330124,0.8110236220472441,52,75,52,75,40,12,12,63
4,49,0.17057666182518005,0.8110236220472441,52,75,52,75,40,12,12,63
5,0,0.7019111514091492,0.4094488188976378,127,0,52,75,52,0,75,0
5,1,3.988959312438965,0.4094488188976378,127,0,52,75,52,0,75,0
5,2,0.9604588150978088,0.5905511811023622,0,127,52,75,0,52,0,75
5,3,0.6926611661911011,0.5905511811023622,0,127,52,75,0,52,0,75
5,4,0.9136322736740112,0.5905511811023622,0,127,52,75,0,52,0,75
5,5,0.887988805770874,0.5905511811023622,0,127,52,75,0,52,0,75
5,6,0.7761815786361694,0.5905511811023622,0,127,52,75,0,52,0,75
5,7,0.7148122787475586,0.5905511811023622,0,127,52,75,0,52,0,75
5,8,0.6864777207374573,0.5905511811023622,0,127,52,75,0,52,0,75
5,9,0.6604568362236023,0.5905511811023622,0,127,52,75,0,52,0,75
5,10,0.6399062275886536,0.5905511811023622,0,127,52,75,0,52,0,75
5,11,0.6142138242721558,0.5905511811023622,0,127,52,75,0,52,0,75
5,12,0.5902925729751587,0.6220472440944882,4,123,52,75,4,48,0,75
5,13,0.5734895467758179,0.7244094488188977,39,88,52,75,28,24,11,64
5,14,0.5450731515884399,0.7086614173228346,45,82,52,75,30,22,15,60
5,15,0.521465003490448,0.7244094488188977,45,82,52,75,31,21,14,61
5,16,0.5179815292358398,0.7165354330708661,52,75,52,75,34,18,18,57
5,17,0.4775567650794983,0.7244094488188977,51,76,52,75,34,18,17,58
5,18,0.4672355353832245,0.7401574803149606,49,78,52,75,34,18,15,60
5,19,0.43668362498283386,0.7244094488188977,41,86,52,75,29,23,12,63
5,20,0.42988818883895874,0.7401574803149606,51,76,52,75,35,17,16,59
5,21,0.4112464189529419,0.7480314960629921,54,73,52,75,37,15,17,58
5,22,0.38927680253982544,0.7401574803149606,55,72,52,75,37,15,18,57
5,23,0.371878981590271,0.7559055118110236,51,76,52,75,36,16,15,60
5,24,0.3553033769130707,0.7401574803149606,49,78,52,75,34,18,15,60
5,25,0.341431200504303,0.7480314960629921,50,77,52,75,35,17,15,60
5,26,0.32906267046928406,0.7559055118110236,49,78,52,75,35,17,14,61
5,27,0.31299468874931335,0.7637795275590551,48,79,52,75,35,17,13,62
5,28,0.3019016981124878,0.7637795275590551,46,81,52,75,34,18,12,63
5,29,0.289823979139328,0.7559055118110236,45,82,52,75,33,19,12,63
5,30,0.2799067199230194,0.7559055118110236,47,80,52,75,34,18,13,62
5,31,0.2708330750465393,0.7559055118110236,47,80,52,75,34,18,13,62
5,32,0.25897786021232605,0.7637795275590551,46,81,52,75,34,18,12,63
5,33,0.24831101298332214,0.7637795275590551,46,81,52,75,34,18,12,63
5,34,0.24531176686286926,0.7637795275590551,48,79,52,75,35,17,13,62
5,35,0.22995828092098236,0.7637795275590551,48,79,52,75,35,17,13,62
5,36,0.2349085807800293,0.7559055118110236,49,78,52,75,35,17,14,61
5,37,0.23215191066265106,0.7637795275590551,46,81,52,75,34,18,12,63
5,38,0.2062557488679886,0.7716535433070866,47,80,52,75,35,17,12,63
5,39,0.2079514116048813,0.7637795275590551,48,79,52,75,35,17,13,62
5,40,0.19687996804714203,0.7716535433070866,49,78,52,75,36,16,13,62
5,41,0.19280967116355896,0.7716535433070866,49,78,52,75,36,16,13,62
5,42,0.1888810396194458,0.7716535433070866,47,80,52,75,35,17,12,63
5,43,0.1868632733821869,0.7874015748031497,45,82,52,75,35,17,10,65
5,44,0.18006040155887604,0.7874015748031497,43,84,52,75,34,18,9,66
5,45,0.16770446300506592,0.7874015748031497,43,84,52,75,34,18,9,66
5,46,0.17472708225250244,0.7874015748031497,43,84,52,75,34,18,9,66
5,47,0.16285255551338196,0.7874015748031497,43,84,52,75,34,18,9,66
5,48,0.16506239771842957,0.7795275590551181,42,85,52,75,33,19,9,66
5,49,0.1586502641439438,0.7795275590551181,42,85,52,75,33,19,9,66
6,0,0.7152987718582153,0.5905511811023622,0,127,52,75,0,52,0,75
6,1,3.414687156677246,0.5905511811023622,0,127,52,75,0,52,0,75
6,2,0.9936453104019165,0.4881889763779528,117,10,52,75,52,0,65,10
6,3,0.6768047213554382,0.4094488188976378,127,0,52,75,52,0,75,0
6,4,0.7523519992828369,0.4094488188976378,127,0,52,75,52,0,75,0
6,5,0.7496938705444336,0.4094488188976378,127,0,52,75,52,0,75,0
6,6,0.7339544892311096,0.4094488188976378,127,0,52,75,52,0,75,0
6,7,0.7123333811759949,0.4094488188976378,127,0,52,75,52,0,75,0
6,8,0.6933060884475708,0.4094488188976378,127,0,52,75,52,0,75,0
6,9,0.6810551285743713,0.4094488188976378,127,0,52,75,52,0,75,0
6,10,0.6663378477096558,0.4094488188976378,127,0,52,75,52,0,75,0
6,11,0.6422320604324341,0.4094488188976378,127,0,52,75,52,0,75,0
6,12,0.6241379380226135,0.4094488188976378,127,0,52,75,52,0,75,0
6,13,0.5944775938987732,0.5275590551181102,104,23,52,75,48,4,56,19
6,14,0.5665342807769775,0.5511811023622047,101,26,52,75,48,4,53,22
6,15,0.544066846370697,0.5905511811023622,96,31,52,75,48,4,48,27
6,16,0.5096324682235718,0.6456692913385826,89,38,52,75,48,4,41,34
6,17,0.48587825894355774,0.6614173228346457,85,42,52,75,47,5,38,37
6,18,0.432354211807251,0.7244094488188977,77,50,52,75,47,5,30,45
6,19,0.3841835558414459,0.7480314960629921,72,55,52,75,46,6,26,49
6,20,0.3472638726234436,0.7795275590551181,68,59,52,75,46,6,22,53
6,21,0.30904772877693176,0.8031496062992126,65,62,52,75,46,6,19,56
6,22,0.28977450728416443,0.7952755905511811,64,63,52,75,45,7,19,56
6,23,0.26257675886154175,0.8267716535433071,60,67,52,75,45,7,15,60
6,24,0.23213490843772888,0.8661417322834646,53,74,52,75,44,8,9,66
6,25,0.2067498415708542,0.8582677165354331,54,73,52,75,44,8,10,65
6,26,0.1965804398059845,0.8661417322834646,55,72,52,75,45,7,10,65
6,27,0.1806633323431015,0.8582677165354331,54,73,52,75,44,8,10,65
6,28,0.1657194346189499,0.8582677165354331,56,71,52,75,45,7,11,64
6,29,0.15905512869358063,0.8503937007874016,55,72,52,75,44,8,11,64
6,30,0.13511277735233307,0.8503937007874016,55,72,52,75,44,8,11,64
6,31,0.1547842025756836,0.8346456692913385,59,68,52,75,45,7,14,61
6,32,0.13324744999408722,0.8267716535433071,62,65,52,75,46,6,16,59
6,33,0.13681143522262573,0.8503937007874016,59,68,52,75,46,6,13,62
6,34,0.11616199463605881,0.8582677165354331,58,69,52,75,46,6,12,63
6,35,0.11964134871959686,0.8582677165354331,58,69,52,75,46,6,12,63
6,36,0.11088516563177109,0.8661417322834646,59,68,52,75,47,5,12,63
6,37,0.09766533225774765,0.8661417322834646,59,68,52,75,47,5,12,63
6,38,0.10082469880580902,0.8661417322834646,57,70,52,75,46,6,11,64
6,39,0.0850478857755661,0.8740157480314961,52,75,52,75,44,8,8,67
6,40,0.08753497898578644,0.8818897637795275,51,76,52,75,44,8,7,68
6,41,0.09105022996664047,0.8818897637795275,51,76,52,75,44,8,7,68
6,42,0.08132091909646988,0.8740157480314961,52,75,52,75,44,8,8,67
6,43,0.06593111902475357,0.8818897637795275,53,74,52,75,45,7,8,67
6,44,0.09255307912826538,0.889763779527559,52,75,52,75,45,7,7,68
6,45,0.07405903190374374,0.8818897637795275,51,76,52,75,44,8,7,68
6,46,0.07132373750209808,0.8740157480314961,52,75,52,75,44,8,8,67
6,47,0.058401357382535934,0.8740157480314961,54,73,52,75,45,7,9,66
6,48,0.05990169197320938,0.8818897637795275,55,72,52,75,46,6,9,66
6,49,0.049452345818281174,0.8818897637795275,59,68,52,75,48,4,11,64
7,0,0.6998366117477417,0.5905511811023622,0,127,52,75,0,52,0,75
7,1,1.5364631414413452,0.4094488188976378,127,0,52,75,52,0,75,0
7,2,1.156855583190918,0.4330708661417323,124,3,52,75,52,0,72,3
7,3,0.6062660217285156,0.7795275590551181,58,69,52,75,41,11,17,58
7,4,0.4316435158252716,0.6535433070866141,18,109,52,75,13,39,5,70
7,5,0.4443741738796234,0.6535433070866141,14,113,52,75,11,41,3,72
7,6,0.4602354168891907,0.6850393700787402,24,103,52,75,18,34,6,69
7,7,0.4436812996864319,0.7874015748031497,41,86,52,75,33,19,8,67
7,8,0.3864663541316986,0.8110236220472441,56,71,52,75,42,10,14,61
7,9,0.3426372706890106,0.7480314960629921,72,55,52,75,46,6,26,49
7,10,0.3191210627555847,0.7165354330708661,76,51,52,75,46,6,30,45
7,11,0.3039987087249756,0.7086614173228346,77,50,52,75,46,6,31,44
7,12,0.2896190583705902,0.7480314960629921,72,55,52,75,46,6,26,49
7,13,0.27083060145378113,0.7952755905511811,62,65,52,75,44,8,18,57
7,14,0.22475792467594147,0.8110236220472441,54,73,52,75,41,11,13,62
7,15,0.20401142537593842,0.7952755905511811,46,81,52,75,36,16,10,65
7,16,0.19181276857852936,0.8031496062992126,45,82,52,75,36,16,9,66
7,17,0.18097788095474243,0.8031496062992126,43,84,52,75,35,17,8,67
7,18,0.1736796349287033,0.7952755905511811,44,83,52,75,35,17,9,66
7,19,0.14602907001972198,0.7952755905511811,46,81,52,75,36,16,10,65
7,20,0.1246783658862114,0.7952755905511811,50,77,52,75,38,14,12,63
7,21,0.1198975071310997,0.8031496062992126,49,78,52,75,38,14,11,64
7,22,0.12464714050292969,0.8031496062992126,49,78,52,75,38,14,11,64
7,23,0.11503759771585464,0.8110236220472441,48,79,52,75,38,14,10,65
7,24,0.09496089816093445,0.8031496062992126,47,80,52,75,37,15,10,65
7,25,0.0930313915014267,0.7874015748031497,45,82,52,75,35,17,10,65
7,26,0.08776896446943283,0.7795275590551181,44,83,52,75,34,18,10,65
7,27,0.07055871188640594,0.7795275590551181,44,83,52,75,34,18,10,65
7,28,0.07404962182044983,0.7795275590551181,44,83,52,75,34,18,10,65
7,29,0.05659865960478783,0.7795275590551181,44,83,52,75,34,18,10,65
7,30,0.05968531221151352,0.7795275590551181,44,83,52,75,34,18,10,65
7,31,0.049699313938617706,0.7874015748031497,45,82,52,75,35,17,10,65
7,32,0.0491492822766304,0.7795275590551181,46,81,52,75,35,17,11,64
7,33,0.055259764194488525,0.7637795275590551,44,83,52,75,33,19,11,64
7,34,0.04445260018110275,0.7716535433070866,45,82,52,75,34,18,11,64
7,35,0.045075494796037674,0.7716535433070866,43,84,52,75,33,19,10,65
7,36,0.03987127169966698,0.7637795275590551,44,83,52,75,33,19,11,64
7,37,0.04519443213939667,0.7795275590551181,46,81,52,75,35,17,11,64
7,38,0.03439891338348389,0.7874015748031497,47,80,52,75,36,16,11,64
7,39,0.03592575341463089,0.7952755905511811,48,79,52,75,37,15,11,64
7,40,0.033408015966415405,0.7795275590551181,50,77,52,75,37,15,13,62
7,41,0.03232453763484955,0.7795275590551181,50,77,52,75,37,15,13,62
7,42,0.03183817118406296,0.7795275590551181,50,77,52,75,37,15,13,62
7,43,0.026230616495013237,0.7874015748031497,51,76,52,75,38,14,13,62
7,44,0.03196365013718605,0.7952755905511811,52,75,52,75,39,13,13,62
7,45,0.025166915729641914,0.8110236220472441,54,73,52,75,41,11,13,62
7,46,0.025009142234921455,0.7952755905511811,54,73,52,75,40,12,14,61
7,47,0.023367123678326607,0.7952755905511811,54,73,52,75,40,12,14,61
7,48,0.01809815689921379,0.7952755905511811,54,73,52,75,40,12,14,61
7,49,0.01833469234406948,0.7952755905511811,54,73,52,75,40,12,14,61
8,0,0.7189751863479614,0.4094488188976378,127,0,52,75,52,0,75,0
8,1,3.5284502506256104,0.4015748031496063,126,1,52,75,51,1,75,0
8,2,0.9787750244140625,0.6692913385826772,34,93,52,75,22,30,12,63
8,3,0.666312038898468,0.5905511811023622,0,127,52,75,0,52,0,75
8,4,0.8570601940155029,0.5905511811023622,0,127,52,75,0,52,0,75
8,5,0.8692212700843811,0.5905511811023622,0,127,52,75,0,52,0,75
8,6,0.8009285926818848,0.5905511811023622,0,127,52,75,0,52,0,75
8,7,0.7467759847640991,0.5905511811023622,0,127,52,75,0,52,0,75
8,8,0.7220588326454163,0.5905511811023622,0,127,52,75,0,52,0,75
8,9,0.7059365510940552,0.5905511811023622,0,127,52,75,0,52,0,75
8,10,0.6949753165245056,0.5905511811023622,0,127,52,75,0,52,0,75
8,11,0.6868222951889038,0.5905511811023622,0,127,52,75,0,52,0,75
8,12,0.6744740009307861,0.5905511811023622,0,127,52,75,0,52,0,75
8,13,0.6603164076805115,0.5905511811023622,0,127,52,75,0,52,0,75
8,14,0.6367543339729309,0.6299212598425197,5,122,52,75,5,47,0,75
8,15,0.6204230785369873,0.6771653543307087,23,104,52,75,17,35,6,69
8,16,0.5930755734443665,0.6771653543307087,31,96,52,75,21,31,10,65
8,17,0.5666617751121521,0.7007874015748031,38,89,52,75,26,26,12,63
8,18,0.5312585234642029,0.7165354330708661,44,83,52,75,30,22,14,61
8,19,0.48586979508399963,0.7086614173228346,53,74,52,75,34,18,19,56
8,20,0.4376123249530792,0.7244094488188977,55,72,52,75,36,16,19,56
8,21,0.401355504989624,0.7480314960629921,56,71,52,75,38,14,18,57
8,22,0.36378175020217896,0.7322834645669292,56,71,52,75,37,15,19,56
8,23,0.33050253987312317,0.7244094488188977,57,70,52,75,37,15,20,55
8,24,0.3083784580230713,0.7086614173228346,51,76,52,75,33,19,18,57
8,25,0.26248782873153687,0.7322834645669292,42,85,52,75,30,22,12,63
8,26,0.2770211398601532,0.7244094488188977,45,82,52,75,31,21,14,61
8,27,0.24288606643676758,0.7322834645669292,42,85,52,75,30,22,12,63
8,28,0.23125632107257843,0.7322834645669292,32,95,52,75,25,27,7,68
8,29,0.19332946836948395,0.7322834645669292,30,97,52,75,24,28,6,69
8,30,0.18050619959831238,0.7244094488188977,31,96,52,75,24,28,7,68
8,31,0.16882239282131195,0.7401574803149606,35,92,52,75,27,25,8,67
8,32,0.19035758078098297,0.7401574803149606,35,92,52,75,27,25,8,67
8,33,0.1520141065120697,0.7559055118110236,37,90,52,75,29,23,8,67
8,34,0.13496153056621552,0.7322834645669292,44,83,52,75,31,21,13,62
8,35,0.11518610268831253,0.7480314960629921,48,79,52,75,34,18,14,61
8,36,0.11918269842863083,0.7322834645669292,54,73,52,75,36,16,18,57
8,37,0.12808556854724884,0.7480314960629921,52,75,52,75,36,16,16,59
8,38,0.09901818633079529,0.7322834645669292,50,77,52,75,34,18,16,59
8,39,0.10310139507055283,0.7480314960629921,48,79,52,75,34,18,14,61
8,40,0.10196321457624435,0.7480314960629921,52,75,52,75,36,16,16,59
8,41,0.07765822857618332,0.7401574803149606,55,72,52,75,37,15,18,57
8,42,0.09435896575450897,0.7322834645669292,54,73,52,75,36,16,18,57
8,43,0.07778501510620117,0.7795275590551181,48,79,52,75,36,16,12,63
8,44,0.07558061927556992,0.7716535433070866,47,80,52,75,35,17,12,63
8,45,0.06973125785589218,0.7716535433070866,47,80,52,75,35,17,12,63
8,46,0.07229176163673401,0.7716535433070866,47,80,52,75,35,17,12,63
8,47,0.06806030869483948,0.7637795275590551,48,79,52,75,35,17,13,62
8,48,0.059274327009916306,0.7559055118110236,49,78,52,75,35,17,14,61
8,49,0.05374867096543312,0.7401574803149606,51,76,52,75,35,17,16,59
9,0,0.7007691264152527,0.5905511811023622,0,127,52,75,0,52,0,75
9,1,0.7952646017074585,0.4094488188976378,127,0,52,75,52,0,75,0
9,2,2.0025455951690674,0.7874015748031497,61,66,52,75,43,9,18,57
9,3,0.42760568857192993,0.6456692913385826,7,120,52,75,7,45,0,75
9,4,0.7697447538375854,0.7637795275590551,22,105,52,75,22,30,0,75
9,5,0.5239111185073853,0.8110236220472441,50,77,52,75,39,13,11,64
9,6,0.3672400116920471,0.7637795275590551,74,53,52,75,48,4,26,49
9,7,0.37472397089004517,0.6929133858267716,87,40,52,75,50,2,37,38
9,8,0.40632516145706177,0.6929133858267716,87,40,52,75,50,2,37,38
9,9,0.3876957893371582,0.7165354330708661,84,43,52,75,50,2,34,41
9,10,0.3372300863265991,0.7795275590551181,74,53,52,75,49,3,25,50
9,11,0.2862476706504822,0.7952755905511811,70,57,52,75,48,4,22,53
9,12,0.25697121024131775,0.8110236220472441,64,63,52,75,46,6,18,57
9,13,0.22978328168392181,0.8188976377952756,57,70,52,75,43,9,14,61
9,14,0.21419785916805267,0.8188976377952756,55,72,52,75,42,10,13,62
9,15,0.19722723960876465,0.8267716535433071,54,73,52,75,42,10,12,63
9,16,0.18845541775226593,0.8110236220472441,56,71,52,75,42,10,14,61
9,17,0.15786747634410858,0.8031496062992126,57,70,52,75,42,10,15,60
9,18,0.13673469424247742,0.7874015748031497,57,70,52,75,41,11,16,59
9,19,0.1264754831790924,0.7874015748031497,57,70,52,75,41,11,16,59
9,20,0.12715749442577362,0.7874015748031497,57,70,52,75,41,11,16,59
9,21,0.11589806526899338,0.7874015748031497,57,70,52,75,41,11,16,59
9,22,0.08816371113061905,0.8031496062992126,55,72,52,75,41,11,14,61
9,23,0.09483425319194794,0.8188976377952756,53,74,52,75,41,11,12,63
9,24,0.08709926903247833,0.8267716535433071,52,75,52,75,41,11,11,64
9,25,0.07449651509523392,0.8346456692913385,49,78,52,75,40,12,9,66
9,26,0.07226014137268066,0.8267716535433071,48,79,52,75,39,13,9,66
9,27,0.060470107942819595,0.8267716535433071,48,79,52,75,39,13,9,66
9,28,0.06711938977241516,0.8188976377952756,47,80,52,75,38,14,9,66
9,29,0.05880898982286453,0.8188976377952756,51,76,52,75,40,12,11,64
9,30,0.0539214201271534,0.8188976377952756,51,76,52,75,40,12,11,64
9,31,0.043681733310222626,0.8110236220472441,52,75,52,75,40,12,12,63
9,32,0.04683158919215202,0.8031496062992126,53,74,52,75,40,12,13,62
9,33,0.04958898201584816,0.8110236220472441,54,73,52,75,41,11,13,62
9,34,0.04622657224535942,0.8110236220472441,54,73,52,75,41,11,13,62
9,35,0.03634616732597351,0.8110236220472441,54,73,52,75,41,11,13,62
9,36,0.0360601469874382,0.8110236220472441,54,73,52,75,41,11,13,62
9,37,0.03455356881022453,0.8188976377952756,53,74,52,75,41,11,12,63
9,38,0.03631160035729408,0.8188976377952756,53,74,52,75,41,11,12,63
9,39,0.03199272230267525,0.8188976377952756,53,74,52,75,41,11,12,63
9,40,0.03152281790971756,0.8188976377952756,53,74,52,75,41,11,12,63
9,41,0.025385873392224312,0.8188976377952756,53,74,52,75,41,11,12,63
9,42,0.026071984320878983,0.8110236220472441,54,73,52,75,41,11,13,62
9,43,0.028754761442542076,0.8110236220472441,54,73,52,75,41,11,13,62
9,44,0.025012612342834473,0.8110236220472441,54,73,52,75,41,11,13,62
9,45,0.024916261434555054,0.8188976377952756,53,74,52,75,41,11,12,63
9,46,0.020085688680410385,0.8188976377952756,53,74,52,75,41,11,12,63
9,47,0.019142938777804375,0.8188976377952756,53,74,52,75,41,11,12,63
9,48,0.023277752101421356,0.8110236220472441,54,73,52,75,41,11,13,62
9,49,0.02027696743607521,0.8110236220472441,54,73,52,75,41,11,13,62
10,0,0.74375319480896,0.4094488188976378,127,0,52,75,52,0,75,0
10,1,3.1844046115875244,0.4094488188976378,127,0,52,75,52,0,75,0
10,2,1.0944159030914307,0.49606299212598426,116,11,52,75,52,0,64,11
10,3,0.6613293886184692,0.5905511811023622,0,127,52,75,0,52,0,75
10,4,0.8643988966941833,0.5905511811023622,0,127,52,75,0,52,0,75
10,5,0.8953702449798584,0.5905511811023622,0,127,52,75,0,52,0,75
10,6,0.8161489963531494,0.5905511811023622,0,127,52,75,0,52,0,75
10,7,0.7507075667381287,0.5905511811023622,0,127,52,75,0,52,0,75
10,8,0.7197943329811096,0.5905511811023622,0,127,52,75,0,52,0,75
10,9,0.7070499062538147,0.5905511811023622,0,127,52,75,0,52,0,75
10,10,0.6991006135940552,0.5905511811023622,0,127,52,75,0,52,0,75
10,11,0.6950016021728516,0.5905511811023622,0,127,52,75,0,52,0,75
10,12,0.6919480562210083,0.5905511811023622,0,127,52,75,0,52,0,75
10,13,0.6892079710960388,0.5905511811023622,0,127,52,75,0,52,0,75
10,14,0.6870949864387512,0.6692913385826772,10,117,52,75,10,42,0,75
10,15,0.6846573948860168,0.7716535433070866,45,82,52,75,34,18,11,64
10,16,0.683128297328949,0.6141732283464567,99,28,52,75,51,1,48,27
10,17,0.68061763048172,0.4094488188976378,125,2,52,75,51,1,74,1
10,18,0.6791436672210693,0.4094488188976378,125,2,52,75,51,1,74,1
10,19,0.6756420135498047,0.41732283464566927,126,1,52,75,52,0,74,1
10,20,0.6731712818145752,0.41732283464566927,126,1,52,75,52,0,74,1
10,21,0.6689867973327637,0.41732283464566927,126,1,52,75,52,0,74,1
10,22,0.6619145274162292,0.41732283464566927,126,1,52,75,52,0,74,1
10,23,0.6560878157615662,0.41732283464566927,126,1,52,75,52,0,74,1
10,24,0.6453184485435486,0.41732283464566927,126,1,52,75,52,0,74,1
10,25,0.6397852301597595,0.4251968503937008,125,2,52,75,52,0,73,2
10,26,0.6328518390655518,0.4645669291338583,120,7,52,75,52,0,68,7
10,27,0.6152483820915222,0.5669291338582677,107,20,52,75,52,0,55,20
10,28,0.6005620956420898,0.6062992125984252,102,25,52,75,52,0,50,25
10,29,0.5853798985481262,0.6456692913385826,97,30,52,75,52,0,45,30
10,30,0.568850576877594,0.6692913385826772,94,33,52,75,52,0,42,33
10,31,0.5461981296539307,0.7244094488188977,83,44,52,75,50,2,33,42
10,32,0.5360191464424133,0.7795275590551181,74,53,52,75,49,3,25,50
10,33,0.5076175332069397,0.7716535433070866,65,62,52,75,44,8,21,54
10,34,0.4867168962955475,0.7874015748031497,61,66,52,75,43,9,18,57
10,35,0.47050702571868896,0.7795275590551181,54,73,52,75,39,13,15,60
10,36,0.44767650961875916,0.7874015748031497,53,74,52,75,39,13,14,61
10,37,0.4263014495372772,0.7874015748031497,53,74,52,75,39,13,14,61
10,38,0.4079407751560211,0.7874015748031497,53,74,52,75,39,13,14,61
10,39,0.3869345188140869,0.7952755905511811,52,75,52,75,39,13,13,62
10,40,0.3694346845149994,0.8031496062992126,47,80,52,75,37,15,10,65
10,41,0.3480566740036011,0.7952755905511811,42,85,52,75,34,18,8,67
10,42,0.32640379667282104,0.7716535433070866,39,88,52,75,31,21,8,67
10,43,0.2960341274738312,0.7795275590551181,36,91,52,75,30,22,6,69
10,44,0.28604376316070557,0.7795275590551181,36,91,52,75,30,22,6,69
10,45,0.2612985074520111,0.7795275590551181,36,91,52,75,30,22,6,69
10,46,0.24796727299690247,0.7716535433070866,35,92,52,75,29,23,6,69
10,47,0.22322265803813934,0.7559055118110236,31,96,52,75,26,26,5,70
10,48,0.20529139041900635,0.7480314960629921,30,97,52,75,25,27,5,70
10,49,0.19226506352424622,0.7480314960629921,30,97,52,75,25,27,5,70
11,0,0.7107439637184143,0.5905511811023622,0,127,52,75,0,52,0,75
11,1,3.0149755477905273,0.5905511811023622,0,127,52,75,0,52,0,75
11,2,0.8886623382568359,0.5905511811023622,0,127,52,75,0,52,0,75
11,3,0.6681879162788391,0.4094488188976378,127,0,52,75,52,0,75,0
11,4,0.7841942310333252,0.4094488188976378,127,0,52,75,52,0,75,0
11,5,0.7950501441955566,0.4094488188976378,127,0,52,75,52,0,75,0
11,6,0.753284752368927,0.4094488188976378,127,0,52,75,52,0,75,0
11,7,0.7215090990066528,0.4094488188976378,127,0,52,75,52,0,75,0
11,8,0.7027415633201599,0.4094488188976378,127,0,52,75,52,0,75,0
11,9,0.693993091583252,0.4094488188976378,127,0,52,75,52,0,75,0
11,10,0.6807308197021484,0.4094488188976378,127,0,52,75,52,0,75,0
11,11,0.6714267730712891,0.4094488188976378,127,0,52,75,52,0,75,0
11,12,0.6470485329627991,0.4094488188976378,127,0,52,75,52,0,75,0
11,13,0.6329406499862671,0.4094488188976378,127,0,52,75,52,0,75,0
11,14,0.6095156669616699,0.5039370078740157,115,12,52,75,52,0,63,12
11,15,0.5917928814888,0.5590551181102362,106,21,52,75,51,1,55,20
11,16,0.5599095225334167,0.5905511811023622,102,25,52,75,51,1,51,24
11,17,0.5269359350204468,0.6062992125984252,100,27,52,75,51,1,49,26
11,18,0.5041107535362244,0.5984251968503937,99,28,52,75,50,2,49,26
11,19,0.47460535168647766,0.6141732283464567,97,30,52,75,50,2,47,28
11,20,0.4495820999145508,0.6220472440944882,94,33,52,75,49,3,45,30
11,21,0.4326428174972534,0.6377952755905512,92,35,52,75,49,3,43,32
11,22,0.41803938150405884,0.6220472440944882,94,33,52,75,49,3,45,30
11,23,0.39428475499153137,0.6299212598425197,97,30,52,75,51,1,46,29
11,24,0.36660969257354736,0.6141732283464567,97,30,52,75,50,2,47,28
11,25,0.36277779936790466,0.6456692913385826,93,34,52,75,50,2,43,32
11,26,0.34289008378982544,0.6929133858267716,85,42,52,75,49,3,36,39
11,27,0.32163360714912415,0.7559055118110236,77,50,52,75,49,3,28,47
11,28,0.310759961605072,0.7559055118110236,75,52,52,75,48,4,27,48
11,29,0.29057246446609497,0.7559055118110236,75,52,52,75,48,4,27,48
11,30,0.2801126539707184,0.7637795275590551,74,53,52,75,48,4,26,49
11,31,0.2642952799797058,0.7637795275590551,72,55,52,75,47,5,25,50
11,32,0.2578459084033966,0.7637795275590551,72,55,52,75,47,5,25,50
11,33,0.2441326081752777,0.7795275590551181,70,57,52,75,47,5,23,52
11,34,0.23049037158489227,0.7795275590551181,70,57,52,75,47,5,23,52
11,35,0.22765249013900757,0.7795275590551181,70,57,52,75,47,5,23,52
11,36,0.21725717186927795,0.7637795275590551,70,57,52,75,46,6,24,51
11,37,0.20672553777694702,0.7559055118110236,69,58,52,75,45,7,24,51
11,38,0.2088327258825302,0.7559055118110236,69,58,52,75,45,7,24,51
11,39,0.20531229674816132,0.7559055118110236,69,58,52,75,45,7,24,51
11,40,0.1934557855129242,0.7559055118110236,69,58,52,75,45,7,24,51
11,41,0.18086430430412292,0.7637795275590551,66,61,52,75,44,8,22,53
11,42,0.18238668143749237,0.7637795275590551,66,61,52,75,44,8,22,53
11,43,0.17481565475463867,0.7637795275590551,66,61,52,75,44,8,22,53
11,44,0.17571449279785156,0.7559055118110236,67,60,52,75,44,8,23,52
11,45,0.17233110964298248,0.7637795275590551,66,61,52,75,44,8,22,53
11,46,0.16458168625831604,0.7637795275590551,66,61,52,75,44,8,22,53
11,47,0.15823982656002045,0.7716535433070866,63,64,52,75,43,9,20,55
11,48,0.15040792524814606,0.7716535433070866,63,64,52,75,43,9,20,55
11,49,0.15259306132793427,0.7716535433070866,63,64,52,75,43,9,20,55
12,0,0.700240969657898,0.4094488188976378,127,0,52,75,52,0,75,0
12,1,3.6258935928344727,0.4094488188976378,127,0,52,75,52,0,75,0
12,2,0.8835567235946655,0.6141732283464567,97,30,52,75,50,2,47,28
12,3,0.6744451522827148,0.5905511811023622,0,127,52,75,0,52,0,75
12,4,0.8901097178459167,0.5905511811023622,0,127,52,75,0,52,0,75
12,5,0.8635081052780151,0.5905511811023622,0,127,52,75,0,52,0,75
12,6,0.7390668392181396,0.5905511811023622,0,127,52,75,0,52,0,75
12,7,0.6804253458976746,0.5905511811023622,0,127,52,75,0,52,0,75
12,8,0.6507878303527832,0.5905511811023622,0,127,52,75,0,52,0,75
12,9,0.6272771954536438,0.5905511811023622,0,127,52,75,0,52,0,75
12,10,0.6179532408714294,0.5905511811023622,0,127,52,75,0,52,0,75
12,11,0.5973590016365051,0.6929133858267716,55,72,52,75,34,18,21,54
12,12,0.5744418501853943,0.6535433070866141,76,51,52,75,42,10,34,41
12,13,0.5450168251991272,0.6614173228346457,75,52,52,75,42,10,33,42
12,14,0.5416704416275024,0.6692913385826772,78,49,52,75,44,8,34,41
12,15,0.502778947353363,0.6929133858267716,79,48,52,75,46,6,33,42
12,16,0.4907880127429962,0.7007874015748031,80,47,52,75,47,5,33,42
12,17,0.4727269411087036,0.7007874015748031,74,53,52,75,44,8,30,45
12,18,0.43807223439216614,0.7401574803149606,65,62,52,75,42,10,23,52
12,19,0.4192291498184204,0.7480314960629921,64,63,52,75,42,10,22,53
12,20,0.40008607506752014,0.7637795275590551,62,65,52,75,42,10,20,55
12,21,0.3793066143989563,0.7637795275590551,62,65,52,75,42,10,20,55
12,22,0.36548975110054016,0.7559055118110236,59,68,52,75,40,12,19,56
12,23,0.35127365589141846,0.7480314960629921,58,69,52,75,39,13,19,56
12,24,0.33177271485328674,0.7401574803149606,55,72,52,75,37,15,18,57
12,25,0.3124436140060425,0.7480314960629921,50,77,52,75,35,17,15,60
12,26,0.3048263490200043,0.7637795275590551,56,71,52,75,39,13,17,58
12,27,0.28913527727127075,0.7716535433070866,61,66,52,75,42,10,19,56
12,28,0.2775692343711853,0.7716535433070866,61,66,52,75,42,10,19,56
12,29,0.26612547039985657,0.7480314960629921,58,69,52,75,39,13,19,56
12,30,0.2574709951877594,0.7637795275590551,56,71,52,75,39,13,17,58
12,31,0.2504962980747223,0.7716535433070866,55,72,52,75,39,13,16,59
12,32,0.23725084960460663,0.7637795275590551,56,71,52,75,39,13,17,58
12,33,0.23116470873355865,0.7716535433070866,57,70,52,75,40,12,17,58
12,34,0.22123217582702637,0.7559055118110236,59,68,52,75,40,12,19,56
12,35,0.21865235269069672,0.7559055118110236,59,68,52,75,40,12,19,56
12,36,0.21020589768886566,0.7637795275590551,56,71,52,75,39,13,17,58
12,37,0.2045290470123291,0.7401574803149606,53,74,52,75,36,16,17,58
12,38,0.20491664111614227,0.7401574803149606,51,76,52,75,35,17,16,59
12,39,0.19358602166175842,0.7559055118110236,49,78,52,75,35,17,14,61
12,40,0.2020011693239212,0.7480314960629921,48,79,52,75,34,18,14,61
12,41,0.18955360352993011,0.7401574803149606,49,78,52,75,34,18,15,60
12,42,0.18539759516716003,0.7401574803149606,47,80,52,75,33,19,14,61
12,43,0.17778891324996948,0.7401574803149606,47,80,52,75,33,19,14,61
12,44,0.16953352093696594,0.7322834645669292,46,81,52,75,32,20,14,61
12,45,0.17435389757156372,0.7401574803149606,49,78,52,75,34,18,15,60
12,46,0.16567055881023407,0.7401574803149606,49,78,52,75,34,18,15,60
12,47,0.15551161766052246,0.7401574803149606,49,78,52,75,34,18,15,60
12,48,0.16278880834579468,0.7401574803149606,49,78,52,75,34,18,15,60
12,49,0.14700154960155487,0.7480314960629921,48,79,52,75,34,18,14,61
13,0,0.6949802041053772,0.5905511811023622,0,127,52,75,0,52,0,75
13,1,4.107778072357178,0.5905511811023622,0,127,52,75,0,52,0,75
13,2,0.8138456344604492,0.4094488188976378,127,0,52,75,52,0,75,0
13,3,0.6667498350143433,0.4094488188976378,127,0,52,75,52,0,75,0
13,4,0.8375566601753235,0.4094488188976378,127,0,52,75,52,0,75,0
13,5,0.7906738519668579,0.4094488188976378,127,0,52,75,52,0,75,0
13,6,0.7294888496398926,0.4094488188976378,127,0,52,75,52,0,75,0
13,7,0.6740121841430664,0.4094488188976378,127,0,52,75,52,0,75,0
13,8,0.654481828212738,0.4094488188976378,127,0,52,75,52,0,75,0
13,9,0.6307111978530884,0.4094488188976378,127,0,52,75,52,0,75,0
13,10,0.6010666489601135,0.4094488188976378,127,0,52,75,52,0,75,0
13,11,0.5850908160209656,0.5433070866141733,102,25,52,75,48,4,54,21
13,12,0.566551923751831,0.5984251968503937,89,38,52,75,45,7,44,31
13,13,0.5383021235466003,0.6771653543307087,69,58,52,75,40,12,29,46
13,14,0.5156094431877136,0.6850393700787402,60,67,52,75,36,16,24,51
13,15,0.4996279776096344,0.6850393700787402,60,67,52,75,36,16,24,51
13,16,0.4694059193134308,0.7007874015748031,66,61,52,75,40,12,26,49
13,17,0.4467320740222931,0.7086614173228346,71,56,52,75,43,9,28,47
13,18,0.41876307129859924,0.7086614173228346,71,56,52,75,43,9,28,47
13,19,0.41050460934638977,0.7086614173228346,71,56,52,75,43,9,28,47
13,20,0.3948685824871063,0.7244094488188977,65,62,52,75,41,11,24,51
13,21,0.370204359292984,0.7007874015748031,62,65,52,75,38,14,24,51
13,22,0.3551171123981476,0.6850393700787402,60,67,52,75,36,16,24,51
13,23,0.3412712514400482,0.7165354330708661,64,63,52,75,40,12,24,51
13,24,0.3149307668209076,0.7244094488188977,67,60,52,75,42,10,25,50
13,25,0.30564624071121216,0.7322834645669292,68,59,52,75,43,9,25,50
13,26,0.2924692630767822,0.7244094488188977,67,60,52,75,42,10,25,50
13,27,0.280477911233902,0.7086614173228346,63,64,52,75,39,13,24,51
13,28,0.2705524265766144,0.7086614173228346,63,64,52,75,39,13,24,51
13,29,0.2523341476917267,0.6929133858267716,61,66,52,75,37,15,24,51
13,30,0.2477482259273529,0.6929133858267716,57,70,52,75,35,17,22,53
13,31,0.23968376219272614,0.6929133858267716,57,70,52,75,35,17,22,53
13,32,0.2305668741464615,0.7165354330708661,56,71,52,75,36,16,20,55
13,33,0.22218620777130127,0.7165354330708661,56,71,52,75,36,16,20,55
13,34,0.20871363580226898,0.7165354330708661,56,71,52,75,36,16,20,55
13,35,0.21014556288719177,0.7244094488188977,55,72,52,75,36,16,19,56
13,36,0.20107345283031464,0.7322834645669292,54,73,52,75,36,16,18,57
13,37,0.19565141201019287,0.7401574803149606,55,72,52,75,37,15,18,57
13,38,0.18560636043548584,0.7322834645669292,58,69,52,75,38,14,20,55
13,39,0.182372584939003,0.7322834645669292,58,69,52,75,38,14,20,55
13,40,0.17038699984550476,0.7322834645669292,58,69,52,75,38,14,20,55
13,41,0.1724330335855484,0.7165354330708661,60,67,52,75,38,14,22,53
13,42,0.162257120013237,0.7165354330708661,60,67,52,75,38,14,22,53
13,43,0.16083979606628418,0.7244094488188977,61,66,52,75,39,13,22,53
13,44,0.15543021261692047,0.7322834645669292,62,65,52,75,40,12,22,53
13,45,0.15635760128498077,0.7322834645669292,62,65,52,75,40,12,22,53
13,46,0.1478516310453415,0.7244094488188977,61,66,52,75,39,13,22,53
13,47,0.13889211416244507,0.7244094488188977,57,70,52,75,37,15,20,55
13,48,0.1370854675769806,0.7244094488188977,57,70,52,75,37,15,20,55
13,49,0.1376889944076538,0.7322834645669292,58,69,52,75,38,14,20,55
14,0,0.7132927179336548,0.5826771653543307,0,127,53,74,0,53,0,74
14,1,3.0936882495880127,0.5826771653543307,0,127,53,74,0,53,0,74
14,2,0.8418398499488831,0.5511811023622047,110,17,53,74,53,0,57,17
14,3,0.6583361625671387,0.41732283464566927,127,0,53,74,53,0,74,0
14,4,0.8492727875709534,0.41732283464566927,127,0,53,74,53,0,74,0
14,5,0.8305325508117676,0.41732283464566927,127,0,53,74,53,0,74,0
14,6,0.7671682238578796,0.41732283464566927,127,0,53,74,53,0,74,0
14,7,0.7331347465515137,0.41732283464566927,127,0,53,74,53,0,74,0
14,8,0.7189908623695374,0.41732283464566927,127,0,53,74,53,0,74,0
14,9,0.7096326947212219,0.41732283464566927,127,0,53,74,53,0,74,0
14,10,0.6953144669532776,0.4409448818897638,124,3,53,74,53,0,71,3
14,11,0.6708382964134216,0.5354330708661418,100,27,53,74,47,6,53,21
14,12,0.6342813968658447,0.6929133858267716,34,93,53,74,24,29,10,64
14,13,0.5986098647117615,0.5984251968503937,2,125,53,74,2,51,0,74
14,14,0.5987091660499573,0.5905511811023622,1,126,53,74,1,52,0,74
14,15,0.5566447377204895,0.5826771653543307,0,127,53,74,0,53,0,74
14,16,0.5242783427238464,0.6141732283464567,4,123,53,74,4,49,0,74
14,17,0.5008655786514282,0.6141732283464567,8,119,53,74,6,47,2,72
14,18,0.46310561895370483,0.6614173228346457,16,111,53,74,13,40,3,71
14,19,0.4238366186618805,0.6850393700787402,19,108,53,74,16,37,3,71
14,20,0.4008195400238037,0.7086614173228346,24,103,53,74,20,33,4,70
14,21,0.3426901698112488,0.7086614173228346,26,101,53,74,21,32,5,69
14,22,0.3200546205043793,0.7165354330708661,27,100,53,74,22,31,5,69
14,23,0.2883927822113037,0.7480314960629921,31,96,53,74,26,27,5,69
14,24,0.27106913924217224,0.7795275590551181,35,92,53,74,30,23,5,69
14,25,0.2852243185043335,0.7716535433070866,42,85,53,74,33,20,9,65
14,26,0.22803106904029846,0.7716535433070866,52,75,53,74,38,15,14,60
14,27,0.23933099210262299,0.7716535433070866,52,75,53,74,38,15,14,60
14,28,0.2242003083229065,0.7716535433070866,48,79,53,74,36,17,12,62
14,29,0.21266494691371918,0.7716535433070866,48,79,53,74,36,17,12,62
14,30,0.19451336562633514,0.7716535433070866,50,77,53,74,37,16,13,61
14,31,0.17072917520999908,0.7874015748031497,56,71,53,74,41,12,15,59
14,32,0.14778220653533936,0.7795275590551181,57,70,53,74,41,12,16,58
14,33,0.15777358412742615,0.7874015748031497,58,69,53,74,42,11,16,58
14,34,0.17295178771018982,0.8031496062992126,56,71,53,74,42,11,14,60
14,35,0.12459893524646759,0.7952755905511811,53,74,53,74,40,13,13,61
14,36,0.12276937812566757,0.7874015748031497,50,77,53,74,38,15,12,62
14,37,0.11853040754795074,0.8031496062992126,52,75,53,74,40,13,12,62
14,38,0.10184180736541748,0.7952755905511811,53,74,53,74,40,13,13,61
14,39,0.09519345313310623,0.7952755905511811,53,74,53,74,40,13,13,61
14,40,0.10203342884778976,0.7952755905511811,53,74,53,74,40,13,13,61
14,41,0.08313541114330292,0.7952755905511811,53,74,53,74,40,13,13,61
14,42,0.07731470465660095,0.7952755905511811,53,74,53,74,40,13,13,61
14,43,0.08291861414909363,0.7874015748031497,54,73,53,74,40,13,14,60
14,44,0.07719013839960098,0.7952755905511811,53,74,53,74,40,13,13,61
14,45,0.06698337197303772,0.7874015748031497,56,71,53,74,41,12,15,59
14,46,0.06937367469072342,0.8031496062992126,58,69,53,74,43,10,15,59
14,47,0.06544671207666397,0.8031496062992126,60,67,53,74,44,9,16,58
14,48,0.05886068940162659,0.7952755905511811,61,66,53,74,44,9,17,57
14,49,0.052257344126701355,0.8110236220472441,59,68,53,74,44,9,15,59
15,0,0.7256301641464233,0.41732283464566927,127,0,53,74,53,0,74,0
15,1,3.4831418991088867,0.41732283464566927,127,0,53,74,53,0,74,0
15,2,0.8953754305839539,0.7480314960629921,71,56,53,74,46,7,25,49
15,3,0.678127646446228,0.5826771653543307,0,127,53,74,0,53,0,74
15,4,0.8246331810951233,0.5826771653543307,0,127,53,74,0,53,0,74
15,5,0.830082893371582,0.5826771653543307,0,127,53,74,0,53,0,74
15,6,0.7809469103813171,0.5826771653543307,0,127,53,74,0,53,0,74
15,7,0.7343820333480835,0.5826771653543307,0,127,53,74,0,53,0,74
15,8,0.7143498659133911,0.5826771653543307,0,127,53,74,0,53,0,74
15,9,0.705059826374054,0.5826771653543307,0,127,53,74,0,53,0,74
15,10,0.700004518032074,0.5826771653543307,0,127,53,74,0,53,0,74
15,11,0.6935592293739319,0.5826771653543307,0,127,53,74,0,53,0,74
15,12,0.6850677728652954,0.5905511811023622,1,126,53,74,1,52,0,74
15,13,0.6777838468551636,0.7086614173228346,28,99,53,74,22,31,6,68
15,14,0.6607915759086609,0.5905511811023622,99,28,53,74,50,3,49,25
15,15,0.6472451686859131,0.47244094488188976,118,9,53,74,52,1,66,8
15,16,0.6349875926971436,0.4409448818897638,124,3,53,74,53,0,71,3
15,17,0.6225919723510742,0.44881889763779526,123,4,53,74,53,0,70,4
15,18,0.6056649088859558,0.4566929133858268,120,7,53,74,52,1,68,6
15,19,0.5936385989189148,0.4645669291338583,117,10,53,74,51,2,66,8
15,20,0.572721540927887,0.5118110236220472,111,16,53,74,51,2,60,14
15,21,0.5652452707290649,0.5196850393700787,110,17,53,74,51,2,59,15
15,22,0.5453664660453796,0.5511811023622047,106,21,53,74,51,2,55,19
15,23,0.5283070802688599,0.5905511811023622,101,26,53,74,51,2,50,24
15,24,0.504837155342102,0.6220472440944882,95,32,53,74,50,3,45,29
15,25,0.4901997148990631,0.6850393700787402,87,40,53,74,50,3,37,37
15,26,0.4693167209625244,0.7165354330708661,83,44,53,74,50,3,33,41
15,27,0.44422778487205505,0.7322834645669292,75,52,53,74,47,6,28,46
15,28,0.42710015177726746,0.7716535433070866,66,61,53,74,45,8,21,53
15,29,0.4049152433872223,0.7637795275590551,55,72,53,74,39,14,16,58
15,30,0.3717421591281891,0.7637795275590551,51,76,53,74,37,16,14,60
15,31,0.3644880950450897,0.7716535433070866,48,79,53,74,36,17,12,62
15,32,0.35269883275032043,0.7716535433070866,48,79,53,74,36,17,12,62
15,33,0.3323242962360382,0.7637795275590551,47,80,53,74,35,18,12,62
15,34,0.32238054275512695,0.7637795275590551,45,82,53,74,34,19,11,63
15,35,0.30629339814186096,0.7637795275590551,45,82,53,74,34,19,11,63
15,36,0.29127371311187744,0.7716535433070866,46,81,53,74,35,18,11,63
15,37,0.2795060873031616,0.7637795275590551,47,80,53,74,35,18,12,62
15,38,0.2606811821460724,0.7637795275590551,47,80,53,74,35,18,12,62
15,39,0.25873881578445435,0.7637795275590551,47,80,53,74,35,18,12,62
15,40,0.24231846630573273,0.7480314960629921,49,78,53,74,35,18,14,60
15,41,0.23676924407482147,0.7480314960629921,49,78,53,74,35,18,14,60
15,42,0.2250891923904419,0.7559055118110236,50,77,53,74,36,17,14,60
15,43,0.22094863653182983,0.7480314960629921,51,76,53,74,36,17,15,59
15,44,0.2074226438999176,0.7480314960629921,51,76,53,74,36,17,15,59
15,45,0.2022065669298172,0.7401574803149606,54,73,53,74,37,16,17,57
15,46,0.20223543047904968,0.7480314960629921,53,74,53,74,37,16,16,58
15,47,0.19306626915931702,0.7559055118110236,52,75,53,74,37,16,15,59
15,48,0.1817689836025238,0.7480314960629921,53,74,53,74,37,16,16,58
15,49,0.17989179491996765,0.7559055118110236,52,75,53,74,37,16,15,59
