Fold,Epoch,Loss,Accuracy,Pred_Real,Pred_Fake,True_Real,True_Fake,TN,FP,FN,TP
1,0,0.6968226432800293,0.4140625,128,0,53,75,53,0,75,0
1,1,1.8669507503509521,0.5859375,0,128,53,75,0,53,0,75
1,2,0.9011152982711792,0.5859375,0,128,53,75,0,53,0,75
1,3,0.7429860234260559,0.59375,1,127,53,75,1,52,0,75
1,4,0.5727008581161499,0.6328125,14,114,53,75,10,43,4,71
1,5,0.5285546779632568,0.6953125,58,70,53,75,36,17,22,53
1,6,0.5288426876068115,0.7109375,68,60,53,75,42,11,26,49
1,7,0.5255494117736816,0.6953125,70,58,53,75,42,11,28,47
1,8,0.4976900815963745,0.7265625,60,68,53,75,39,14,21,54
1,9,0.46517038345336914,0.7265625,54,74,53,75,36,17,18,57
1,10,0.4150944650173187,0.7265625,42,86,53,75,30,23,12,63
1,11,0.374589204788208,0.7265625,34,94,53,75,26,27,8,67
1,12,0.3446670174598694,0.71875,31,97,53,75,24,29,7,68
1,13,0.32440951466560364,0.7109375,32,96,53,75,24,29,8,67
1,14,0.30327099561691284,0.75,41,87,53,75,31,22,10,65
1,15,0.26898664236068726,0.7578125,48,80,53,75,35,18,13,62
1,16,0.24886392056941986,0.7421875,52,76,53,75,36,17,16,59
1,17,0.23292048275470734,0.734375,57,71,53,75,38,15,19,56
1,18,0.2219223529100418,0.734375,61,67,53,75,40,13,21,54
1,19,0.2114228904247284,0.7265625,62,66,53,75,40,13,22,53
1,20,0.18857377767562866,0.75,59,69,53,75,40,13,19,56
1,21,0.18170946836471558,0.734375,55,73,53,75,37,16,18,57
1,22,0.16410423815250397,0.734375,55,73,53,75,37,16,18,57
1,23,0.16956669092178345,0.7421875,52,76,53,75,36,17,16,59
1,24,0.14269986748695374,0.7578125,50,78,53,75,36,17,14,61
1,25,0.13406239449977875,0.7578125,50,78,53,75,36,17,14,61
1,26,0.12073514610528946,0.7578125,50,78,53,75,36,17,14,61
1,27,0.12497042119503021,0.765625,51,77,53,75,37,16,14,61
1,28,0.11003369837999344,0.765625,51,77,53,75,37,16,14,61
1,29,0.10186832398176193,0.7734375,52,76,53,75,38,15,14,61
1,30,0.09996199607849121,0.765625,51,77,53,75,37,16,14,61
1,31,0.08676499128341675,0.75,49,79,53,75,35,18,14,61
1,32,0.09268991649150848,0.75,49,79,53,75,35,18,14,61
1,33,0.08195284754037857,0.7421875,50,78,53,75,35,18,15,60
1,34,0.0797172412276268,0.75,51,77,53,75,36,17,15,60
1,35,0.07683397829532623,0.75,51,77,53,75,36,17,15,60
1,36,0.07675697654485703,0.7421875,52,76,53,75,36,17,16,59
1,37,0.06633634865283966,0.7421875,52,76,53,75,36,17,16,59
1,38,0.0712316706776619,0.7421875,52,76,53,75,36,17,16,59
1,39,0.06906469166278839,0.7421875,52,76,53,75,36,17,16,59
1,40,0.06264717131853104,0.7421875,52,76,53,75,36,17,16,59
1,41,0.06620202958583832,0.7421875,52,76,53,75,36,17,16,59
1,42,0.06908593326807022,0.7421875,52,76,53,75,36,17,16,59
1,43,0.05295419692993164,0.7421875,52,76,53,75,36,17,16,59
1,44,0.0553581528365612,0.7421875,52,76,53,75,36,17,16,59
1,45,0.04900652542710304,0.7421875,52,76,53,75,36,17,16,59
1,46,0.06119602173566818,0.7421875,52,76,53,75,36,17,16,59
1,47,0.056476179510354996,0.7421875,52,76,53,75,36,17,16,59
1,48,0.05075233057141304,0.7578125,50,78,53,75,36,17,14,61
1,49,0.04725929722189903,0.7578125,50,78,53,75,36,17,14,61
2,0,0.7056975960731506,0.4094488188976378,127,0,52,75,52,0,75,0
2,1,3.456057071685791,0.4094488188976378,127,0,52,75,52,0,75,0
2,2,0.8985105752944946,0.5984251968503937,1,126,52,75,1,51,0,75
2,3,0.6822625398635864,0.5905511811023622,0,127,52,75,0,52,0,75
2,4,0.8812837600708008,0.5905511811023622,0,127,52,75,0,52,0,75
2,5,0.864169716835022,0.5905511811023622,0,127,52,75,0,52,0,75
2,6,0.7538280487060547,0.5905511811023622,0,127,52,75,0,52,0,75
2,7,0.6974190473556519,0.5905511811023622,0,127,52,75,0,52,0,75
2,8,0.6517970561981201,0.5905511811023622,0,127,52,75,0,52,0,75
2,9,0.6305605173110962,0.5905511811023622,0,127,52,75,0,52,0,75
2,10,0.6000362038612366,0.7244094488188977,31,96,52,75,24,28,7,68
2,11,0.5605425834655762,0.7716535433070866,51,76,52,75,37,15,14,61
2,12,0.5552213788032532,0.7952755905511811,58,69,52,75,42,10,16,59
2,13,0.5351765155792236,0.8031496062992126,61,66,52,75,44,8,17,58
2,14,0.513155996799469,0.8031496062992126,67,60,52,75,47,5,20,55
2,15,0.4852496385574341,0.7952755905511811,72,55,52,75,49,3,23,52
2,16,0.4699966013431549,0.7952755905511811,72,55,52,75,49,3,23,52
2,17,0.45679301023483276,0.7874015748031497,71,56,52,75,48,4,23,52
2,18,0.4233853220939636,0.7874015748031497,69,58,52,75,47,5,22,53
2,19,0.4105668365955353,0.7874015748031497,67,60,52,75,46,6,21,54
2,20,0.40888309478759766,0.7874015748031497,67,60,52,75,46,6,21,54
2,21,0.39606547355651855,0.7952755905511811,70,57,52,75,48,4,22,53
2,22,0.3572893440723419,0.7795275590551181,70,57,52,75,47,5,23,52
2,23,0.3604885935783386,0.7952755905511811,66,61,52,75,46,6,20,55
2,24,0.35107100009918213,0.7952755905511811,62,65,52,75,44,8,18,57
2,25,0.32424166798591614,0.7716535433070866,59,68,52,75,41,11,18,57
2,26,0.3242422640323639,0.7795275590551181,56,71,52,75,40,12,16,59
2,27,0.3152138888835907,0.7795275590551181,56,71,52,75,40,12,16,59
2,28,0.2942999303340912,0.7874015748031497,57,70,52,75,41,11,16,59
2,29,0.2836065888404846,0.8110236220472441,56,71,52,75,42,10,14,61
2,30,0.2942052483558655,0.8110236220472441,56,71,52,75,42,10,14,61
2,31,0.26175037026405334,0.8031496062992126,55,72,52,75,41,11,14,61
2,32,0.2591506242752075,0.8110236220472441,54,73,52,75,41,11,13,62
2,33,0.25293678045272827,0.8110236220472441,54,73,52,75,41,11,13,62
2,34,0.24704989790916443,0.8110236220472441,54,73,52,75,41,11,13,62
2,35,0.24734905362129211,0.8188976377952756,57,70,52,75,43,9,14,61
2,36,0.23518319427967072,0.8346456692913385,59,68,52,75,45,7,14,61
2,37,0.22106915712356567,0.8346456692913385,59,68,52,75,45,7,14,61
2,38,0.22456763684749603,0.84251968503937,60,67,52,75,46,6,14,61
2,39,0.22247806191444397,0.8346456692913385,57,70,52,75,44,8,13,62
2,40,0.2199621945619583,0.8031496062992126,53,74,52,75,40,12,13,62
2,41,0.21879097819328308,0.8031496062992126,53,74,52,75,40,12,13,62
2,42,0.19826321303844452,0.8031496062992126,55,72,52,75,41,11,14,61
2,43,0.19821037352085114,0.8110236220472441,52,75,52,75,40,12,12,63
2,44,0.20122568309307098,0.8110236220472441,52,75,52,75,40,12,12,63
2,45,0.19292832911014557,0.8267716535433071,46,81,52,75,38,14,8,67
2,46,0.18421125411987305,0.8267716535433071,46,81,52,75,38,14,8,67
2,47,0.19178904592990875,0.8188976377952756,45,82,52,75,37,15,8,67
2,48,0.18247762322425842,0.8188976377952756,47,80,52,75,38,14,9,66
2,49,0.18325728178024292,0.8267716535433071,50,77,52,75,40,12,10,65
3,0,0.6925804615020752,0.5905511811023622,0,127,52,75,0,52,0,75
3,1,3.232841968536377,0.6141732283464567,5,122,52,75,4,48,1,74
3,2,0.765758216381073,0.4094488188976378,127,0,52,75,52,0,75,0
3,3,0.6786266565322876,0.4094488188976378,127,0,52,75,52,0,75,0
3,4,0.8429701924324036,0.4094488188976378,127,0,52,75,52,0,75,0
3,5,0.8520032167434692,0.4094488188976378,127,0,52,75,52,0,75,0
3,6,0.801474928855896,0.4094488188976378,127,0,52,75,52,0,75,0
3,7,0.7622767686843872,0.4094488188976378,127,0,52,75,52,0,75,0
3,8,0.724911630153656,0.4094488188976378,127,0,52,75,52,0,75,0
3,9,0.6981989741325378,0.4094488188976378,127,0,52,75,52,0,75,0
3,10,0.676117479801178,0.4094488188976378,127,0,52,75,52,0,75,0
3,11,0.661971926689148,0.4094488188976378,127,0,52,75,52,0,75,0
3,12,0.6394810080528259,0.4094488188976378,127,0,52,75,52,0,75,0
3,13,0.6137031316757202,0.7244094488188977,29,98,52,75,23,29,6,69
3,14,0.5915511846542358,0.7086614173228346,23,104,52,75,19,33,4,71
3,15,0.5629958510398865,0.7401574803149606,29,98,52,75,24,28,5,70
3,16,0.5403760671615601,0.7637795275590551,34,93,52,75,28,24,6,69
3,17,0.5160083770751953,0.7637795275590551,32,95,52,75,27,25,5,70
3,18,0.49169766902923584,0.7244094488188977,25,102,52,75,21,31,4,71
3,19,0.46350204944610596,0.7401574803149606,25,102,52,75,22,30,3,72
3,20,0.4582770764827728,0.7795275590551181,32,95,52,75,28,24,4,71
3,21,0.42148831486701965,0.7716535433070866,35,92,52,75,29,23,6,69
3,22,0.41314899921417236,0.7716535433070866,33,94,52,75,28,24,5,70
3,23,0.39850640296936035,0.7795275590551181,30,97,52,75,27,25,3,72
3,24,0.3829185366630554,0.7716535433070866,31,96,52,75,27,25,4,71
3,25,0.3669116199016571,0.7952755905511811,38,89,52,75,32,20,6,69
3,26,0.3461880087852478,0.8188976377952756,43,84,52,75,36,16,7,68
3,27,0.3355129063129425,0.8031496062992126,37,90,52,75,32,20,5,70
3,28,0.3150034546852112,0.8031496062992126,37,90,52,75,32,20,5,70
3,29,0.3076412081718445,0.8110236220472441,44,83,52,75,36,16,8,67
3,30,0.29258179664611816,0.8031496062992126,47,80,52,75,37,15,10,65
3,31,0.276401162147522,0.7952755905511811,48,79,52,75,37,15,11,64
3,32,0.2639372646808624,0.7952755905511811,48,79,52,75,37,15,11,64
3,33,0.2570315897464752,0.8031496062992126,49,78,52,75,38,14,11,64
3,34,0.25482407212257385,0.8110236220472441,50,77,52,75,39,13,11,64
3,35,0.24222849309444427,0.8110236220472441,50,77,52,75,39,13,11,64
3,36,0.24194729328155518,0.8110236220472441,50,77,52,75,39,13,11,64
3,37,0.2362971007823944,0.8110236220472441,50,77,52,75,39,13,11,64
3,38,0.22361691296100616,0.8110236220472441,50,77,52,75,39,13,11,64
3,39,0.22653545439243317,0.8267716535433071,52,75,52,75,41,11,11,64
3,40,0.2240012139081955,0.8346456692913385,53,74,52,75,42,10,11,64
3,41,0.2133062481880188,0.8346456692913385,53,74,52,75,42,10,11,64
3,42,0.20778971910476685,0.8267716535433071,52,75,52,75,41,11,11,64
3,43,0.20513777434825897,0.8346456692913385,53,74,52,75,42,10,11,64
3,44,0.18645696341991425,0.8267716535433071,56,71,52,75,43,9,13,62
3,45,0.20529969036579132,0.8110236220472441,54,73,52,75,41,11,13,62
3,46,0.1951216161251068,0.8267716535433071,52,75,52,75,41,11,11,64
3,47,0.19118422269821167,0.8267716535433071,52,75,52,75,41,11,11,64
3,48,0.179318368434906,0.8188976377952756,53,74,52,75,41,11,12,63
3,49,0.17899110913276672,0.8110236220472441,54,73,52,75,41,11,13,62
4,0,0.7014203667640686,0.4094488188976378,127,0,52,75,52,0,75,0
4,1,3.2780401706695557,0.4094488188976378,127,0,52,75,52,0,75,0
4,2,0.8638202548027039,0.5905511811023622,0,127,52,75,0,52,0,75
4,3,0.7081051468849182,0.5905511811023622,0,127,52,75,0,52,0,75
4,4,0.8896092176437378,0.5905511811023622,0,127,52,75,0,52,0,75
4,5,0.8601285815238953,0.5905511811023622,0,127,52,75,0,52,0,75
4,6,0.7794702649116516,0.5905511811023622,0,127,52,75,0,52,0,75
4,7,0.7281469702720642,0.5905511811023622,0,127,52,75,0,52,0,75
4,8,0.6951324343681335,0.5905511811023622,0,127,52,75,0,52,0,75
4,9,0.6770215630531311,0.5905511811023622,0,127,52,75,0,52,0,75
4,10,0.6641868352890015,0.5905511811023622,0,127,52,75,0,52,0,75
4,11,0.6486133933067322,0.5905511811023622,0,127,52,75,0,52,0,75
4,12,0.6343988180160522,0.5984251968503937,75,52,52,75,38,14,37,38
4,13,0.6091770529747009,0.6141732283464567,99,28,52,75,51,1,48,27
4,14,0.5837109684944153,0.6377952755905512,96,31,52,75,51,1,45,30
4,15,0.5712630152702332,0.6377952755905512,96,31,52,75,51,1,45,30
4,16,0.5416914820671082,0.6614173228346457,93,34,52,75,51,1,42,33
4,17,0.5211858153343201,0.6771653543307087,91,36,52,75,51,1,40,35
4,18,0.502608060836792,0.6850393700787402,86,41,52,75,49,3,37,38
4,19,0.47087085247039795,0.6929133858267716,83,44,52,75,48,4,35,40
4,20,0.4605942964553833,0.7086614173228346,81,46,52,75,48,4,33,42
4,21,0.4323316216468811,0.7322834645669292,76,51,52,75,47,5,29,46
4,22,0.4166799783706665,0.7401574803149606,75,52,52,75,47,5,28,47
4,23,0.40246519446372986,0.7480314960629921,74,53,52,75,47,5,27,48
4,24,0.38310134410858154,0.7480314960629921,72,55,52,75,46,6,26,49
4,25,0.3806054890155792,0.7559055118110236,71,56,52,75,46,6,25,50
4,26,0.35018330812454224,0.7480314960629921,70,57,52,75,45,7,25,50
4,27,0.33860084414482117,0.7559055118110236,71,56,52,75,46,6,25,50
4,28,0.3262768089771271,0.7559055118110236,71,56,52,75,46,6,25,50
4,29,0.31391775608062744,0.7559055118110236,71,56,52,75,46,6,25,50
4,30,0.3278781473636627,0.7559055118110236,73,54,52,75,47,5,26,49
4,31,0.3124006390571594,0.7559055118110236,73,54,52,75,47,5,26,49
4,32,0.29094424843788147,0.7559055118110236,73,54,52,75,47,5,26,49
4,33,0.27454397082328796,0.7480314960629921,70,57,52,75,45,7,25,50
4,34,0.27113258838653564,0.7322834645669292,68,59,52,75,43,9,25,50
4,35,0.277564138174057,0.7401574803149606,69,58,52,75,44,8,25,50
4,36,0.2584187388420105,0.7480314960629921,70,57,52,75,45,7,25,50
4,37,0.2560570240020752,0.7480314960629921,70,57,52,75,45,7,25,50
4,38,0.24477221071720123,0.7401574803149606,69,58,52,75,44,8,25,50
4,39,0.2329225391149521,0.7401574803149606,69,58,52,75,44,8,25,50
4,40,0.22895242273807526,0.7401574803149606,69,58,52,75,44,8,25,50
4,41,0.2338976263999939,0.7401574803149606,67,60,52,75,43,9,24,51
4,42,0.2216951847076416,0.7401574803149606,67,60,52,75,43,9,24,51
4,43,0.2094373255968094,0.7401574803149606,67,60,52,75,43,9,24,51
4,44,0.2163652777671814,0.7401574803149606,67,60,52,75,43,9,24,51
4,45,0.20508526265621185,0.7480314960629921,66,61,52,75,43,9,23,52
4,46,0.2022535651922226,0.7480314960629921,66,61,52,75,43,9,23,52
4,47,0.19631437957286835,0.7480314960629921,66,61,52,75,43,9,23,52
4,48,0.19283822178840637,0.7480314960629921,66,61,52,75,43,9,23,52
4,49,0.18841864168643951,0.7480314960629921,66,61,52,75,43,9,23,52
5,0,0.7078900337219238,0.4094488188976378,127,0,52,75,52,0,75,0
5,1,3.4473354816436768,0.4094488188976378,127,0,52,75,52,0,75,0
5,2,0.9760050773620605,0.5905511811023622,0,127,52,75,0,52,0,75
5,3,0.6901518106460571,0.5905511811023622,0,127,52,75,0,52,0,75
5,4,0.8489790558815002,0.5905511811023622,0,127,52,75,0,52,0,75
5,5,0.8626840114593506,0.5905511811023622,0,127,52,75,0,52,0,75
5,6,0.807648777961731,0.5905511811023622,0,127,52,75,0,52,0,75
5,7,0.743048906326294,0.5905511811023622,0,127,52,75,0,52,0,75
5,8,0.7016023993492126,0.5905511811023622,0,127,52,75,0,52,0,75
5,9,0.6752649545669556,0.5905511811023622,0,127,52,75,0,52,0,75
5,10,0.6569283604621887,0.5905511811023622,0,127,52,75,0,52,0,75
5,11,0.6482725739479065,0.5905511811023622,0,127,52,75,0,52,0,75
5,12,0.6207384467124939,0.6062992125984252,40,87,52,75,21,31,19,56
5,13,0.5970559120178223,0.6692913385826772,68,59,52,75,39,13,29,46
5,14,0.5813606977462769,0.7086614173228346,69,58,52,75,42,10,27,48
5,15,0.5661181211471558,0.7086614173228346,69,58,52,75,42,10,27,48
5,16,0.5425772070884705,0.7007874015748031,70,57,52,75,42,10,28,47
5,17,0.5209503173828125,0.7007874015748031,70,57,52,75,42,10,28,47
5,18,0.5115139484405518,0.7322834645669292,64,63,52,75,41,11,23,52
5,19,0.49347278475761414,0.7244094488188977,65,62,52,75,41,11,24,51
5,20,0.46300241351127625,0.7322834645669292,68,59,52,75,43,9,25,50
5,21,0.4472846984863281,0.7559055118110236,63,64,52,75,42,10,21,54
5,22,0.4332245886325836,0.7874015748031497,59,68,52,75,42,10,17,58
5,23,0.40966638922691345,0.7874015748031497,59,68,52,75,42,10,17,58
5,24,0.3861951529979706,0.7874015748031497,59,68,52,75,42,10,17,58
5,25,0.3730839788913727,0.8031496062992126,59,68,52,75,43,9,16,59
5,26,0.3656809329986572,0.8031496062992126,59,68,52,75,43,9,16,59
5,27,0.351015567779541,0.7952755905511811,56,71,52,75,41,11,15,60
5,28,0.34112274646759033,0.7874015748031497,55,72,52,75,40,12,15,60
5,29,0.3221364915370941,0.7952755905511811,54,73,52,75,40,12,14,61
5,30,0.31489598751068115,0.7874015748031497,53,74,52,75,39,13,14,61
5,31,0.3021303117275238,0.7952755905511811,52,75,52,75,39,13,13,62
5,32,0.293133944272995,0.7795275590551181,50,77,52,75,37,15,13,62
5,33,0.28909164667129517,0.7795275590551181,48,79,52,75,36,16,12,63
5,34,0.267934650182724,0.7874015748031497,47,80,52,75,36,16,11,64
5,35,0.2653552293777466,0.7795275590551181,48,79,52,75,36,16,12,63
5,36,0.26222261786460876,0.7952755905511811,50,77,52,75,38,14,12,63
5,37,0.24492233991622925,0.8031496062992126,51,76,52,75,39,13,12,63
5,38,0.24034710228443146,0.8031496062992126,51,76,52,75,39,13,12,63
5,39,0.23832693696022034,0.8031496062992126,49,78,52,75,38,14,11,64
5,40,0.2310398519039154,0.8110236220472441,50,77,52,75,39,13,11,64
5,41,0.239829882979393,0.8110236220472441,50,77,52,75,39,13,11,64
5,42,0.2195884734392166,0.8110236220472441,50,77,52,75,39,13,11,64
5,43,0.20365333557128906,0.8110236220472441,50,77,52,75,39,13,11,64
5,44,0.2106124758720398,0.8110236220472441,50,77,52,75,39,13,11,64
5,45,0.20110994577407837,0.8110236220472441,50,77,52,75,39,13,11,64
5,46,0.20390920341014862,0.8110236220472441,50,77,52,75,39,13,11,64
5,47,0.19237345457077026,0.8110236220472441,50,77,52,75,39,13,11,64
5,48,0.19725275039672852,0.8110236220472441,50,77,52,75,39,13,11,64
5,49,0.19598671793937683,0.8031496062992126,49,78,52,75,38,14,11,64
6,0,0.7235131859779358,0.4094488188976378,127,0,52,75,52,0,75,0
6,1,2.8193435668945312,0.4094488188976378,127,0,52,75,52,0,75,0
6,2,0.8778448700904846,0.5590551181102362,104,23,52,75,50,2,54,21
6,3,0.6737193465232849,0.5905511811023622,0,127,52,75,0,52,0,75
6,4,0.8116598129272461,0.5905511811023622,0,127,52,75,0,52,0,75
6,5,0.837751030921936,0.5905511811023622,0,127,52,75,0,52,0,75
6,6,0.7976198792457581,0.5905511811023622,0,127,52,75,0,52,0,75
6,7,0.7514045834541321,0.5905511811023622,0,127,52,75,0,52,0,75
6,8,0.7222338318824768,0.5905511811023622,0,127,52,75,0,52,0,75
6,9,0.7087604999542236,0.5905511811023622,0,127,52,75,0,52,0,75
6,10,0.6999145150184631,0.5905511811023622,0,127,52,75,0,52,0,75
6,11,0.6862545013427734,0.5905511811023622,0,127,52,75,0,52,0,75
6,12,0.6785802245140076,0.5905511811023622,0,127,52,75,0,52,0,75
6,13,0.6674163937568665,0.5905511811023622,0,127,52,75,0,52,0,75
6,14,0.6602247357368469,0.7322834645669292,70,57,52,75,44,8,26,49
6,15,0.642066478729248,0.7086614173228346,79,48,52,75,47,5,32,43
6,16,0.6276552677154541,0.6692913385826772,86,41,52,75,48,4,38,37
6,17,0.6075887680053711,0.6771653543307087,87,40,52,75,49,3,38,37
6,18,0.5879724621772766,0.7007874015748031,84,43,52,75,49,3,35,40
6,19,0.5678292512893677,0.7165354330708661,80,47,52,75,48,4,32,43
6,20,0.5425258874893188,0.7086614173228346,79,48,52,75,47,5,32,43
6,21,0.527830958366394,0.7322834645669292,72,55,52,75,45,7,27,48
6,22,0.49699142575263977,0.7559055118110236,69,58,52,75,45,7,24,51
6,23,0.46714019775390625,0.7637795275590551,68,59,52,75,45,7,23,52
6,24,0.4449481964111328,0.7795275590551181,66,61,52,75,45,7,21,54
6,25,0.4470328390598297,0.7716535433070866,63,64,52,75,43,9,20,55
6,26,0.4126908779144287,0.7874015748031497,63,64,52,75,44,8,19,56
6,27,0.3935818076133728,0.7874015748031497,63,64,52,75,44,8,19,56
6,28,0.38982608914375305,0.7874015748031497,63,64,52,75,44,8,19,56
6,29,0.36280733346939087,0.7795275590551181,64,63,52,75,44,8,20,55
6,30,0.34535402059555054,0.7795275590551181,64,63,52,75,44,8,20,55
6,31,0.33198896050453186,0.7795275590551181,64,63,52,75,44,8,20,55
6,32,0.32092776894569397,0.7795275590551181,64,63,52,75,44,8,20,55
6,33,0.32048121094703674,0.7716535433070866,65,62,52,75,44,8,21,54
6,34,0.2931385338306427,0.7716535433070866,65,62,52,75,44,8,21,54
6,35,0.284955233335495,0.7716535433070866,65,62,52,75,44,8,21,54
6,36,0.28086021542549133,0.7716535433070866,65,62,52,75,44,8,21,54
6,37,0.26527151465415955,0.7716535433070866,65,62,52,75,44,8,21,54
6,38,0.2584480047225952,0.7637795275590551,66,61,52,75,44,8,22,53
6,39,0.249240905046463,0.7874015748031497,63,64,52,75,44,8,19,56
6,40,0.24350465834140778,0.7716535433070866,61,66,52,75,42,10,19,56
6,41,0.24230986833572388,0.7716535433070866,61,66,52,75,42,10,19,56
6,42,0.2372206151485443,0.7795275590551181,60,67,52,75,42,10,18,57
6,43,0.22835847735404968,0.7716535433070866,61,66,52,75,42,10,19,56
6,44,0.20882250368595123,0.7716535433070866,63,64,52,75,43,9,20,55
6,45,0.21438993513584137,0.7795275590551181,62,65,52,75,43,9,19,56
6,46,0.20438198745250702,0.7795275590551181,62,65,52,75,43,9,19,56
6,47,0.2231854349374771,0.7716535433070866,65,62,52,75,44,8,21,54
6,48,0.2000231295824051,0.7795275590551181,66,61,52,75,45,7,21,54
6,49,0.2340151071548462,0.7795275590551181,66,61,52,75,45,7,21,54
7,0,0.7017560005187988,0.5905511811023622,0,127,52,75,0,52,0,75
7,1,1.1767939329147339,0.4094488188976378,127,0,52,75,52,0,75,0
7,2,1.4898921251296997,0.4094488188976378,127,0,52,75,52,0,75,0
7,3,0.7321464419364929,0.6771653543307087,81,46,52,75,46,6,35,40
7,4,0.532973051071167,0.7165354330708661,32,95,52,75,24,28,8,67
7,5,0.5561047196388245,0.6929133858267716,21,106,52,75,17,35,4,71
7,6,0.5914446711540222,0.7086614173228346,25,102,52,75,20,32,5,70
7,7,0.5662875175476074,0.7795275590551181,42,85,52,75,33,19,9,66
7,8,0.5427454710006714,0.7795275590551181,62,65,52,75,43,9,19,56
7,9,0.45563915371894836,0.7244094488188977,77,50,52,75,47,5,30,45
7,10,0.43360042572021484,0.7007874015748031,86,41,52,75,50,2,36,39
7,11,0.3958186209201813,0.6850393700787402,88,39,52,75,50,2,38,37
7,12,0.3598266839981079,0.7244094488188977,81,46,52,75,49,3,32,43
7,13,0.3383367657661438,0.7637795275590551,72,55,52,75,47,5,25,50
7,14,0.30061352252960205,0.8110236220472441,62,65,52,75,45,7,17,58
7,15,0.2761913537979126,0.8267716535433071,52,75,52,75,41,11,11,64
7,16,0.2390040010213852,0.7874015748031497,45,82,52,75,35,17,10,65
7,17,0.23620451986789703,0.7874015748031497,41,86,52,75,33,19,8,67
7,18,0.2430858463048935,0.7874015748031497,41,86,52,75,33,19,8,67
7,19,0.21887712180614471,0.7874015748031497,45,82,52,75,35,17,10,65
7,20,0.19113753736019135,0.7952755905511811,48,79,52,75,37,15,11,64
7,21,0.16774258017539978,0.7874015748031497,51,76,52,75,38,14,13,62
7,22,0.15875092148780823,0.7795275590551181,52,75,52,75,38,14,14,61
7,23,0.17311719059944153,0.7874015748031497,51,76,52,75,38,14,13,62
7,24,0.1521712690591812,0.7716535433070866,49,78,52,75,36,16,13,62
7,25,0.1163930743932724,0.7874015748031497,45,82,52,75,35,17,10,65
7,26,0.13084746897220612,0.7716535433070866,43,84,52,75,33,19,10,65
7,27,0.10737576335668564,0.7559055118110236,41,86,52,75,31,21,10,65
7,28,0.11040804535150528,0.7559055118110236,41,86,52,75,31,21,10,65
7,29,0.09684649109840393,0.7480314960629921,42,85,52,75,31,21,11,64
7,30,0.08750294893980026,0.7716535433070866,45,82,52,75,34,18,11,64
7,31,0.0936381071805954,0.7874015748031497,49,78,52,75,37,15,12,63
7,32,0.08715344965457916,0.7952755905511811,50,77,52,75,38,14,12,63
7,33,0.08949583023786545,0.8031496062992126,51,76,52,75,39,13,12,63
7,34,0.0694131925702095,0.8031496062992126,51,76,52,75,39,13,12,63
7,35,0.07564640045166016,0.7952755905511811,50,77,52,75,38,14,12,63
7,36,0.06907619535923004,0.7874015748031497,49,78,52,75,37,15,12,63
7,37,0.07464061677455902,0.7795275590551181,50,77,52,75,37,15,13,62
7,38,0.0669451355934143,0.7795275590551181,50,77,52,75,37,15,13,62
7,39,0.05755111575126648,0.7716535433070866,49,78,52,75,36,16,13,62
7,40,0.042754773050546646,0.7795275590551181,48,79,52,75,36,16,12,63
7,41,0.04884311184287071,0.7874015748031497,49,78,52,75,37,15,12,63
7,42,0.06579906493425369,0.7952755905511811,50,77,52,75,38,14,12,63
7,43,0.051535334438085556,0.7874015748031497,51,76,52,75,38,14,13,62
7,44,0.04207642376422882,0.7874015748031497,51,76,52,75,38,14,13,62
7,45,0.034808143973350525,0.7795275590551181,52,75,52,75,38,14,14,61
7,46,0.043561290949583054,0.7795275590551181,52,75,52,75,38,14,14,61
7,47,0.04425153136253357,0.7795275590551181,52,75,52,75,38,14,14,61
7,48,0.047466062009334564,0.7716535433070866,53,74,52,75,38,14,15,60
7,49,0.0396423414349556,0.7795275590551181,54,73,52,75,39,13,15,60
8,0,0.7085274457931519,0.5905511811023622,0,127,52,75,0,52,0,75
8,1,2.9729621410369873,0.5905511811023622,0,127,52,75,0,52,0,75
8,2,0.9242796301841736,0.4409448818897638,123,4,52,75,52,0,71,4
8,3,0.6982806324958801,0.4094488188976378,127,0,52,75,52,0,75,0
8,4,0.8411679267883301,0.4094488188976378,127,0,52,75,52,0,75,0
8,5,0.846861720085144,0.4094488188976378,127,0,52,75,52,0,75,0
8,6,0.7731098532676697,0.4094488188976378,127,0,52,75,52,0,75,0
8,7,0.7401885986328125,0.4094488188976378,127,0,52,75,52,0,75,0
8,8,0.716108500957489,0.4094488188976378,127,0,52,75,52,0,75,0
8,9,0.7030779123306274,0.4094488188976378,127,0,52,75,52,0,75,0
8,10,0.6944159269332886,0.4094488188976378,127,0,52,75,52,0,75,0
8,11,0.6887924671173096,0.4094488188976378,127,0,52,75,52,0,75,0
8,12,0.6844552755355835,0.4094488188976378,127,0,52,75,52,0,75,0
8,13,0.6800311803817749,0.4094488188976378,127,0,52,75,52,0,75,0
8,14,0.672204852104187,0.6456692913385826,57,70,52,75,32,20,25,50
8,15,0.6624078750610352,0.6377952755905512,44,83,52,75,25,27,19,56
8,16,0.6581466794013977,0.6929133858267716,57,70,52,75,35,17,22,53
8,17,0.6369034647941589,0.6692913385826772,78,49,52,75,44,8,34,41
8,18,0.6203479170799255,0.5826771653543307,97,30,52,75,48,4,49,26
8,19,0.6006588935852051,0.5118110236220472,108,19,52,75,49,3,59,16
8,20,0.5766398906707764,0.5039370078740157,109,18,52,75,49,3,60,15
8,21,0.555907666683197,0.5118110236220472,108,19,52,75,49,3,59,16
8,22,0.5273991227149963,0.5196850393700787,107,20,52,75,49,3,58,17
8,23,0.49443483352661133,0.5354330708661418,105,22,52,75,49,3,56,19
8,24,0.45455771684646606,0.5511811023622047,99,28,52,75,47,5,52,23
8,25,0.42946940660476685,0.6141732283464567,91,36,52,75,47,5,44,31
8,26,0.4140326976776123,0.6299212598425197,89,38,52,75,47,5,42,33
8,27,0.34780192375183105,0.6692913385826772,82,45,52,75,46,6,36,39
8,28,0.33494487404823303,0.7244094488188977,71,56,52,75,44,8,27,48
8,29,0.3000372350215912,0.7007874015748031,60,67,52,75,37,15,23,52
8,30,0.2810586392879486,0.7086614173228346,55,72,52,75,35,17,20,55
8,31,0.26646795868873596,0.7244094488188977,51,76,52,75,34,18,17,58
8,32,0.2380187213420868,0.7480314960629921,40,87,52,75,30,22,10,65
8,33,0.23259638249874115,0.7637795275590551,40,87,52,75,31,21,9,66
8,34,0.1993074268102646,0.7637795275590551,36,91,52,75,29,23,7,68
8,35,0.20285354554653168,0.7716535433070866,37,90,52,75,30,22,7,68
8,36,0.23261971771717072,0.7559055118110236,35,92,52,75,28,24,7,68
8,37,0.1761249154806137,0.7559055118110236,35,92,52,75,28,24,7,68
8,38,0.19321581721305847,0.7559055118110236,35,92,52,75,28,24,7,68
8,39,0.18488232791423798,0.7480314960629921,46,81,52,75,33,19,13,62
8,40,0.18398842215538025,0.7322834645669292,50,77,52,75,34,18,16,59
8,41,0.21473164856433868,0.7322834645669292,48,79,52,75,33,19,15,60
8,42,0.14222027361392975,0.7244094488188977,43,84,52,75,30,22,13,62
8,43,0.1639404445886612,0.7322834645669292,42,85,52,75,30,22,12,63
8,44,0.17436441779136658,0.7401574803149606,45,82,52,75,32,20,13,62
8,45,0.13521699607372284,0.7480314960629921,46,81,52,75,33,19,13,62
8,46,0.13744957745075226,0.7480314960629921,46,81,52,75,33,19,13,62
8,47,0.14802880585193634,0.7480314960629921,46,81,52,75,33,19,13,62
8,48,0.16349564492702484,0.7559055118110236,45,82,52,75,33,19,12,63
8,49,0.10151998698711395,0.7401574803149606,43,84,52,75,31,21,12,63
9,0,0.6988641619682312,0.4094488188976378,127,0,52,75,52,0,75,0
9,1,1.4003148078918457,0.5905511811023622,0,127,52,75,0,52,0,75
9,2,1.7839179039001465,0.5905511811023622,0,127,52,75,0,52,0,75
9,3,0.9797772765159607,0.6299212598425197,7,120,52,75,6,46,1,74
9,4,0.5469461679458618,0.7322834645669292,76,51,52,75,47,5,29,46
9,5,0.5513466000556946,0.6299212598425197,95,32,52,75,50,2,45,30
9,6,0.6115444302558899,0.5905511811023622,102,25,52,75,51,1,51,24
9,7,0.5850014090538025,0.6141732283464567,97,30,52,75,50,2,47,28
9,8,0.5774917006492615,0.6692913385826772,90,37,52,75,50,2,40,35
9,9,0.5390245914459229,0.7244094488188977,83,44,52,75,50,2,33,42
9,10,0.5201103687286377,0.8267716535433071,64,63,52,75,47,5,17,58
9,11,0.46795764565467834,0.8267716535433071,50,77,52,75,40,12,10,65
9,12,0.43340903520584106,0.8267716535433071,46,81,52,75,38,14,8,67
9,13,0.4193858504295349,0.84251968503937,42,85,52,75,37,15,5,70
9,14,0.39143291115760803,0.84251968503937,44,83,52,75,38,14,6,69
9,15,0.35724255442619324,0.8346456692913385,49,78,52,75,40,12,9,66
9,16,0.3270670771598816,0.8346456692913385,53,74,52,75,42,10,11,64
9,17,0.2963051497936249,0.8110236220472441,60,67,52,75,44,8,16,59
9,18,0.28395718336105347,0.8110236220472441,60,67,52,75,44,8,16,59
9,19,0.266777366399765,0.8031496062992126,61,66,52,75,44,8,17,58
9,20,0.24050819873809814,0.8110236220472441,60,67,52,75,44,8,16,59
9,21,0.24749387800693512,0.8031496062992126,61,66,52,75,44,8,17,58
9,22,0.2205752730369568,0.8031496062992126,61,66,52,75,44,8,17,58
9,23,0.2113465815782547,0.8031496062992126,61,66,52,75,44,8,17,58
9,24,0.1899465173482895,0.8110236220472441,58,69,52,75,43,9,15,60
9,25,0.1890142560005188,0.7952755905511811,56,71,52,75,41,11,15,60
9,26,0.17587578296661377,0.7952755905511811,54,73,52,75,40,12,14,61
9,27,0.14794011414051056,0.8031496062992126,53,74,52,75,40,12,13,62
9,28,0.13854657113552094,0.8110236220472441,54,73,52,75,41,11,13,62
9,29,0.1402275115251541,0.8110236220472441,54,73,52,75,41,11,13,62
9,30,0.12619610130786896,0.8110236220472441,54,73,52,75,41,11,13,62
9,31,0.11967765539884567,0.8110236220472441,54,73,52,75,41,11,13,62
9,32,0.12216301262378693,0.8110236220472441,54,73,52,75,41,11,13,62
9,33,0.11430530250072479,0.8110236220472441,54,73,52,75,41,11,13,62
9,34,0.10143426060676575,0.8110236220472441,54,73,52,75,41,11,13,62
9,35,0.09569274634122849,0.8188976377952756,53,74,52,75,41,11,12,63
9,36,0.0844702422618866,0.8188976377952756,53,74,52,75,41,11,12,63
9,37,0.09002266079187393,0.8188976377952756,53,74,52,75,41,11,12,63
9,38,0.08420052379369736,0.8188976377952756,53,74,52,75,41,11,12,63
9,39,0.08296005427837372,0.8188976377952756,53,74,52,75,41,11,12,63
9,40,0.08134176582098007,0.8188976377952756,53,74,52,75,41,11,12,63
9,41,0.07549049705266953,0.8188976377952756,53,74,52,75,41,11,12,63
9,42,0.08171474933624268,0.8188976377952756,53,74,52,75,41,11,12,63
9,43,0.07271338254213333,0.8110236220472441,54,73,52,75,41,11,13,62
9,44,0.0715271383523941,0.8188976377952756,53,74,52,75,41,11,12,63
9,45,0.06482873857021332,0.8110236220472441,54,73,52,75,41,11,13,62
9,46,0.05571962520480156,0.8110236220472441,54,73,52,75,41,11,13,62
9,47,0.05494992062449455,0.8110236220472441,56,71,52,75,42,10,14,61
9,48,0.0632815957069397,0.8110236220472441,56,71,52,75,42,10,14,61
9,49,0.06965763866901398,0.8031496062992126,57,70,52,75,42,10,15,60
10,0,0.699739396572113,0.4094488188976378,127,0,52,75,52,0,75,0
10,1,3.3010377883911133,0.4094488188976378,127,0,52,75,52,0,75,0
10,2,0.8822353482246399,0.5905511811023622,0,127,52,75,0,52,0,75
10,3,0.703973650932312,0.5905511811023622,0,127,52,75,0,52,0,75
10,4,0.866064190864563,0.5905511811023622,0,127,52,75,0,52,0,75
10,5,0.8193661570549011,0.5905511811023622,0,127,52,75,0,52,0,75
10,6,0.7471768856048584,0.5905511811023622,0,127,52,75,0,52,0,75
10,7,0.6845662593841553,0.5905511811023622,0,127,52,75,0,52,0,75
10,8,0.6707903146743774,0.5905511811023622,0,127,52,75,0,52,0,75
10,9,0.6457270383834839,0.5905511811023622,0,127,52,75,0,52,0,75
10,10,0.624587893486023,0.6692913385826772,18,109,52,75,14,38,4,71
10,11,0.608202338218689,0.7480314960629921,32,95,52,75,26,26,6,69
10,12,0.5829529762268066,0.7401574803149606,57,70,52,75,38,14,19,56
10,13,0.5570169687271118,0.7007874015748031,68,59,52,75,41,11,27,48
10,14,0.5346064567565918,0.7165354330708661,74,53,52,75,45,7,29,46
10,15,0.5333980321884155,0.7322834645669292,76,51,52,75,47,5,29,46
10,16,0.5044487714767456,0.7322834645669292,76,51,52,75,47,5,29,46
10,17,0.48418954014778137,0.7401574803149606,71,56,52,75,45,7,26,49
10,18,0.4697015881538391,0.7322834645669292,62,65,52,75,40,12,22,53
10,19,0.4487367272377014,0.7401574803149606,59,68,52,75,39,13,20,55
10,20,0.4303649067878723,0.7480314960629921,58,69,52,75,39,13,19,56
10,21,0.41319340467453003,0.7480314960629921,60,67,52,75,40,12,20,55
10,22,0.3894917070865631,0.7559055118110236,61,66,52,75,41,11,20,55
10,23,0.38158196210861206,0.7559055118110236,59,68,52,75,40,12,19,56
10,24,0.3577428162097931,0.7874015748031497,53,74,52,75,39,13,14,61
10,25,0.3508068323135376,0.8110236220472441,48,79,52,75,38,14,10,65
10,26,0.3475867509841919,0.7952755905511811,48,79,52,75,37,15,11,64
10,27,0.32494664192199707,0.8110236220472441,48,79,52,75,38,14,10,65
10,28,0.3308572769165039,0.7874015748031497,53,74,52,75,39,13,14,61
10,29,0.304257869720459,0.7795275590551181,56,71,52,75,40,12,16,59
10,30,0.29630759358406067,0.7637795275590551,58,69,52,75,40,12,18,57
10,31,0.3000309467315674,0.7952755905511811,54,73,52,75,40,12,14,61
10,32,0.29087281227111816,0.7952755905511811,50,77,52,75,38,14,12,63
10,33,0.2737121880054474,0.8031496062992126,49,78,52,75,38,14,11,64
10,34,0.262249618768692,0.8031496062992126,49,78,52,75,38,14,11,64
10,35,0.25372573733329773,0.8031496062992126,51,76,52,75,39,13,12,63
10,36,0.24931077659130096,0.8188976377952756,53,74,52,75,41,11,12,63
10,37,0.24363617599010468,0.8188976377952756,53,74,52,75,41,11,12,63
10,38,0.23673072457313538,0.8188976377952756,53,74,52,75,41,11,12,63
10,39,0.22983668744564056,0.8188976377952756,53,74,52,75,41,11,12,63
10,40,0.22364108264446259,0.8188976377952756,53,74,52,75,41,11,12,63
10,41,0.2211219221353531,0.8188976377952756,53,74,52,75,41,11,12,63
10,42,0.22311188280582428,0.8188976377952756,53,74,52,75,41,11,12,63
10,43,0.2032649964094162,0.8110236220472441,56,71,52,75,42,10,14,61
10,44,0.21271952986717224,0.8110236220472441,56,71,52,75,42,10,14,61
10,45,0.18965239822864532,0.8110236220472441,58,69,52,75,43,9,15,60
10,46,0.20225906372070312,0.8031496062992126,55,72,52,75,41,11,14,61
10,47,0.1820480078458786,0.8110236220472441,54,73,52,75,41,11,13,62
10,48,0.18878377974033356,0.8110236220472441,54,73,52,75,41,11,13,62
10,49,0.1787596046924591,0.8110236220472441,54,73,52,75,41,11,13,62
11,0,0.723846971988678,0.4094488188976378,127,0,52,75,52,0,75,0
11,1,3.3095459938049316,0.4094488188976378,127,0,52,75,52,0,75,0
11,2,0.9936195611953735,0.4094488188976378,127,0,52,75,52,0,75,0
11,3,0.6880892515182495,0.5905511811023622,0,127,52,75,0,52,0,75
11,4,0.7561907172203064,0.5905511811023622,0,127,52,75,0,52,0,75
11,5,0.782576858997345,0.5905511811023622,0,127,52,75,0,52,0,75
11,6,0.7452223300933838,0.5905511811023622,0,127,52,75,0,52,0,75
11,7,0.7127132415771484,0.5905511811023622,0,127,52,75,0,52,0,75
11,8,0.6924947500228882,0.5905511811023622,0,127,52,75,0,52,0,75
11,9,0.683661162853241,0.5905511811023622,0,127,52,75,0,52,0,75
11,10,0.675477147102356,0.5905511811023622,0,127,52,75,0,52,0,75
11,11,0.6726034283638,0.5905511811023622,0,127,52,75,0,52,0,75
11,12,0.6651473045349121,0.5905511811023622,0,127,52,75,0,52,0,75
11,13,0.6534457206726074,0.5905511811023622,0,127,52,75,0,52,0,75
11,14,0.6438680291175842,0.6692913385826772,66,61,52,75,38,14,28,47
11,15,0.6285526156425476,0.7244094488188977,63,64,52,75,40,12,23,52
11,16,0.6206487417221069,0.7716535433070866,61,66,52,75,42,10,19,56
11,17,0.5984975099563599,0.7716535433070866,63,64,52,75,43,9,20,55
11,18,0.5742165446281433,0.7637795275590551,64,63,52,75,43,9,21,54
11,19,0.5618314146995544,0.7401574803149606,65,62,52,75,42,10,23,52
11,20,0.5414375066757202,0.7559055118110236,61,66,52,75,41,11,20,55
11,21,0.5271750688552856,0.7401574803149606,59,68,52,75,39,13,20,55
11,22,0.502947211265564,0.7637795275590551,54,73,52,75,38,14,16,59
11,23,0.4864477217197418,0.7716535433070866,55,72,52,75,39,13,16,59
11,24,0.4491257667541504,0.7716535433070866,55,72,52,75,39,13,16,59
11,25,0.44146728515625,0.7716535433070866,55,72,52,75,39,13,16,59
11,26,0.4181453287601471,0.7874015748031497,57,70,52,75,41,11,16,59
11,27,0.4125230312347412,0.7952755905511811,58,69,52,75,42,10,16,59
11,28,0.3983500599861145,0.8031496062992126,59,68,52,75,43,9,16,59
11,29,0.37997516989707947,0.7952755905511811,60,67,52,75,43,9,17,58
11,30,0.3732062578201294,0.7952755905511811,60,67,52,75,43,9,17,58
11,31,0.34337714314460754,0.7874015748031497,61,66,52,75,43,9,18,57
11,32,0.3435421586036682,0.7874015748031497,61,66,52,75,43,9,18,57
11,33,0.3238816261291504,0.7795275590551181,62,65,52,75,43,9,19,56
11,34,0.3203067183494568,0.7874015748031497,61,66,52,75,43,9,18,57
11,35,0.29584187269210815,0.7795275590551181,58,69,52,75,41,11,17,58
11,36,0.2920578420162201,0.7952755905511811,56,71,52,75,41,11,15,60
11,37,0.2836553454399109,0.7952755905511811,56,71,52,75,41,11,15,60
11,38,0.2750301957130432,0.7952755905511811,56,71,52,75,41,11,15,60
11,39,0.26100820302963257,0.7952755905511811,56,71,52,75,41,11,15,60
11,40,0.2606833577156067,0.7874015748031497,55,72,52,75,40,12,15,60
11,41,0.2588432729244232,0.7874015748031497,51,76,52,75,38,14,13,62
11,42,0.24592971801757812,0.7795275590551181,50,77,52,75,37,15,13,62
11,43,0.25124391913414,0.7795275590551181,50,77,52,75,37,15,13,62
11,44,0.23263582587242126,0.7795275590551181,50,77,52,75,37,15,13,62
11,45,0.22322896122932434,0.7874015748031497,51,76,52,75,38,14,13,62
11,46,0.21481288969516754,0.7795275590551181,54,73,52,75,39,13,15,60
11,47,0.2085728645324707,0.7795275590551181,54,73,52,75,39,13,15,60
11,48,0.20545826852321625,0.7716535433070866,53,74,52,75,38,14,15,60
11,49,0.198114812374115,0.7795275590551181,50,77,52,75,37,15,13,62
12,0,0.7056940793991089,0.5905511811023622,0,127,52,75,0,52,0,75
12,1,3.091301202774048,0.5905511811023622,0,127,52,75,0,52,0,75
12,2,0.9350572824478149,0.5905511811023622,0,127,52,75,0,52,0,75
12,3,0.68816739320755,0.4094488188976378,127,0,52,75,52,0,75,0
12,4,0.7810287475585938,0.4094488188976378,127,0,52,75,52,0,75,0
12,5,0.7951154708862305,0.4094488188976378,127,0,52,75,52,0,75,0
12,6,0.763224720954895,0.4094488188976378,127,0,52,75,52,0,75,0
12,7,0.7134931087493896,0.4094488188976378,127,0,52,75,52,0,75,0
12,8,0.6823638677597046,0.4094488188976378,127,0,52,75,52,0,75,0
12,9,0.6645500063896179,0.4094488188976378,127,0,52,75,52,0,75,0
12,10,0.6554237008094788,0.4094488188976378,127,0,52,75,52,0,75,0
12,11,0.635653018951416,0.4094488188976378,127,0,52,75,52,0,75,0
12,12,0.6258684992790222,0.5669291338582677,99,28,52,75,48,4,51,24
12,13,0.6030808091163635,0.6377952755905512,82,45,52,75,44,8,38,37
12,14,0.5820691585540771,0.7007874015748031,70,57,52,75,42,10,28,47
12,15,0.5552862882614136,0.7874015748031497,57,70,52,75,41,11,16,59
12,16,0.5373318791389465,0.8346456692913385,49,78,52,75,40,12,9,66
12,17,0.5119407773017883,0.8346456692913385,49,78,52,75,40,12,9,66
12,18,0.49250736832618713,0.8267716535433071,48,79,52,75,39,13,9,66
12,19,0.4579092264175415,0.8267716535433071,50,77,52,75,40,12,10,65
12,20,0.4427420198917389,0.84251968503937,48,79,52,75,40,12,8,67
12,21,0.419555127620697,0.84251968503937,46,81,52,75,39,13,7,68
12,22,0.3963117003440857,0.84251968503937,48,79,52,75,40,12,8,67
12,23,0.37243229150772095,0.8346456692913385,49,78,52,75,40,12,9,66
12,24,0.358915776014328,0.8267716535433071,48,79,52,75,39,13,9,66
12,25,0.3367125988006592,0.7874015748031497,41,86,52,75,33,19,8,67
12,26,0.2988187372684479,0.7874015748031497,39,88,52,75,32,20,7,68
12,27,0.2931815981864929,0.7795275590551181,42,85,52,75,33,19,9,66
12,28,0.27695196866989136,0.7874015748031497,43,84,52,75,34,18,9,66
12,29,0.27824702858924866,0.7952755905511811,42,85,52,75,34,18,8,67
12,30,0.24176454544067383,0.7874015748031497,39,88,52,75,32,20,7,68
12,31,0.24499352276325226,0.7952755905511811,38,89,52,75,32,20,6,69
12,32,0.21760892868041992,0.7874015748031497,37,90,52,75,31,21,6,69
12,33,0.21569012105464935,0.7874015748031497,37,90,52,75,31,21,6,69
12,34,0.20734724402427673,0.7795275590551181,36,91,52,75,30,22,6,69
12,35,0.18016235530376434,0.7716535433070866,35,92,52,75,29,23,6,69
12,36,0.17877711355686188,0.7952755905511811,38,89,52,75,32,20,6,69
12,37,0.17339059710502625,0.7874015748031497,37,90,52,75,31,21,6,69
12,38,0.17769865691661835,0.7874015748031497,39,88,52,75,32,20,7,68
12,39,0.14566724002361298,0.7952755905511811,40,87,52,75,33,19,7,68
12,40,0.13949936628341675,0.7795275590551181,44,83,52,75,34,18,10,65
12,41,0.15217804908752441,0.7874015748031497,41,86,52,75,33,19,8,67
12,42,0.13065896928310394,0.7874015748031497,41,86,52,75,33,19,8,67
12,43,0.14328701794147491,0.7952755905511811,42,85,52,75,34,18,8,67
12,44,0.11980428546667099,0.7952755905511811,44,83,52,75,35,17,9,66
12,45,0.12487943470478058,0.8031496062992126,41,86,52,75,34,18,7,68
12,46,0.1276816725730896,0.8031496062992126,37,90,52,75,32,20,5,70
12,47,0.14717260003089905,0.8031496062992126,37,90,52,75,32,20,5,70
12,48,0.12359502911567688,0.8031496062992126,39,88,52,75,33,19,6,69
12,49,0.16407625377178192,0.8031496062992126,37,90,52,75,32,20,5,70
13,0,0.6972095966339111,0.4094488188976378,127,0,52,75,52,0,75,0
13,1,3.264678955078125,0.4094488188976378,127,0,52,75,52,0,75,0
13,2,0.9171557426452637,0.5905511811023622,0,127,52,75,0,52,0,75
13,3,0.6829270720481873,0.5905511811023622,0,127,52,75,0,52,0,75
13,4,0.877221405506134,0.5905511811023622,0,127,52,75,0,52,0,75
13,5,0.9019547700881958,0.5905511811023622,0,127,52,75,0,52,0,75
13,6,0.817030131816864,0.5905511811023622,0,127,52,75,0,52,0,75
13,7,0.7340438961982727,0.5905511811023622,0,127,52,75,0,52,0,75
13,8,0.6864914894104004,0.5905511811023622,0,127,52,75,0,52,0,75
13,9,0.6670920848846436,0.5905511811023622,0,127,52,75,0,52,0,75
13,10,0.6446304321289062,0.5905511811023622,0,127,52,75,0,52,0,75
13,11,0.6222714185714722,0.7322834645669292,48,79,52,75,33,19,15,60
13,12,0.6152647137641907,0.7165354330708661,64,63,52,75,40,12,24,51
13,13,0.5845137238502502,0.7244094488188977,71,56,52,75,44,8,27,48
13,14,0.5634115934371948,0.7559055118110236,77,50,52,75,49,3,28,47
13,15,0.5441446900367737,0.7480314960629921,76,51,52,75,48,4,28,47
13,16,0.5386344790458679,0.7480314960629921,76,51,52,75,48,4,28,47
13,17,0.5022376775741577,0.7559055118110236,73,54,52,75,47,5,26,49
13,18,0.4876417815685272,0.7716535433070866,71,56,52,75,47,5,24,51
13,19,0.46734336018562317,0.7874015748031497,67,60,52,75,46,6,21,54
13,20,0.45793038606643677,0.7874015748031497,65,62,52,75,45,7,20,55
13,21,0.4293345808982849,0.7559055118110236,59,68,52,75,40,12,19,56
13,22,0.4165235757827759,0.7716535433070866,61,66,52,75,42,10,19,56
13,23,0.39002150297164917,0.7716535433070866,61,66,52,75,42,10,19,56
13,24,0.3873097598552704,0.7716535433070866,61,66,52,75,42,10,19,56
13,25,0.361421674489975,0.7795275590551181,60,67,52,75,42,10,18,57
13,26,0.34832578897476196,0.7952755905511811,56,71,52,75,41,11,15,60
13,27,0.3312959372997284,0.8188976377952756,57,70,52,75,43,9,14,61
13,28,0.3168541491031647,0.8110236220472441,56,71,52,75,42,10,14,61
13,29,0.3079216480255127,0.8188976377952756,55,72,52,75,42,10,13,62
13,30,0.3010304570198059,0.8110236220472441,54,73,52,75,41,11,13,62
13,31,0.2858272194862366,0.8031496062992126,55,72,52,75,41,11,14,61
13,32,0.286741703748703,0.7952755905511811,56,71,52,75,41,11,15,60
13,33,0.2747049033641815,0.7874015748031497,59,68,52,75,42,10,17,58
13,34,0.26632818579673767,0.7795275590551181,60,67,52,75,42,10,18,57
13,35,0.2610625624656677,0.7874015748031497,59,68,52,75,42,10,17,58
13,36,0.2489958107471466,0.7874015748031497,59,68,52,75,42,10,17,58
13,37,0.24320735037326813,0.7874015748031497,57,70,52,75,41,11,16,59
13,38,0.23299366235733032,0.7952755905511811,58,69,52,75,42,10,16,59
13,39,0.22884675860404968,0.7952755905511811,58,69,52,75,42,10,16,59
13,40,0.22762013971805573,0.7952755905511811,58,69,52,75,42,10,16,59
13,41,0.21232733130455017,0.7952755905511811,58,69,52,75,42,10,16,59
13,42,0.21220730245113373,0.7795275590551181,58,69,52,75,41,11,17,58
13,43,0.2081872671842575,0.7795275590551181,58,69,52,75,41,11,17,58
13,44,0.19994038343429565,0.7795275590551181,58,69,52,75,41,11,17,58
13,45,0.19160671532154083,0.7795275590551181,58,69,52,75,41,11,17,58
13,46,0.19049330055713654,0.7795275590551181,56,71,52,75,40,12,16,59
13,47,0.19163060188293457,0.7874015748031497,57,70,52,75,41,11,16,59
13,48,0.1887931376695633,0.7716535433070866,57,70,52,75,40,12,17,58
13,49,0.18034686148166656,0.7795275590551181,56,71,52,75,40,12,16,59
14,0,0.7010892033576965,0.41732283464566927,127,0,53,74,53,0,74,0
14,1,3.177889823913574,0.41732283464566927,127,0,53,74,53,0,74,0
14,2,0.860435426235199,0.5826771653543307,0,127,53,74,0,53,0,74
14,3,0.6771267056465149,0.5826771653543307,0,127,53,74,0,53,0,74
14,4,0.8065469861030579,0.5826771653543307,0,127,53,74,0,53,0,74
14,5,0.8385865688323975,0.5826771653543307,0,127,53,74,0,53,0,74
14,6,0.7658445835113525,0.5826771653543307,0,127,53,74,0,53,0,74
14,7,0.7162250876426697,0.5826771653543307,0,127,53,74,0,53,0,74
14,8,0.6785644292831421,0.5826771653543307,0,127,53,74,0,53,0,74
14,9,0.6540281176567078,0.5826771653543307,0,127,53,74,0,53,0,74
14,10,0.6333169937133789,0.5826771653543307,0,127,53,74,0,53,0,74
14,11,0.6094304919242859,0.6535433070866141,9,118,53,74,9,44,0,74
14,12,0.5828349590301514,0.7559055118110236,28,99,53,74,25,28,3,71
14,13,0.5620627403259277,0.7637795275590551,41,86,53,74,32,21,9,65
14,14,0.5356923937797546,0.7322834645669292,53,74,53,74,36,17,17,57
14,15,0.5302255153656006,0.7401574803149606,70,57,53,74,45,8,25,49
14,16,0.49640804529190063,0.7480314960629921,71,56,53,74,46,7,25,49
14,17,0.48864316940307617,0.7322834645669292,71,56,53,74,45,8,26,48
14,18,0.46259090304374695,0.7401574803149606,66,61,53,74,43,10,23,51
14,19,0.45065242052078247,0.7637795275590551,61,66,53,74,42,11,19,55
14,20,0.42204374074935913,0.7559055118110236,64,63,53,74,43,10,21,53
14,21,0.40503615140914917,0.7480314960629921,65,62,53,74,43,10,22,52
14,22,0.3852803707122803,0.7244094488188977,68,59,53,74,43,10,25,49
14,23,0.36785998940467834,0.7165354330708661,67,60,53,74,42,11,25,49
14,24,0.35547295212745667,0.7480314960629921,63,64,53,74,42,11,21,53
14,25,0.3421193063259125,0.7795275590551181,59,68,53,74,42,11,17,57
14,26,0.3297264277935028,0.7716535433070866,56,71,53,74,40,13,16,58
14,27,0.31839922070503235,0.7795275590551181,55,72,53,74,40,13,15,59
14,28,0.3073831796646118,0.7716535433070866,58,69,53,74,41,12,17,57
14,29,0.2978162169456482,0.7716535433070866,58,69,53,74,41,12,17,57
14,30,0.2755719721317291,0.7795275590551181,55,72,53,74,40,13,15,59
14,31,0.28330346941947937,0.7795275590551181,55,72,53,74,40,13,15,59
14,32,0.28087118268013,0.7716535433070866,56,71,53,74,40,13,16,58
14,33,0.2524814009666443,0.7716535433070866,56,71,53,74,40,13,16,58
14,34,0.2407345473766327,0.7716535433070866,56,71,53,74,40,13,16,58
14,35,0.24342098832130432,0.7637795275590551,55,72,53,74,39,14,16,58
14,36,0.23951120674610138,0.7559055118110236,56,71,53,74,39,14,17,57
14,37,0.21544688940048218,0.7559055118110236,56,71,53,74,39,14,17,57
14,38,0.22030121088027954,0.7559055118110236,56,71,53,74,39,14,17,57
14,39,0.20930972695350647,0.7559055118110236,62,65,53,74,42,11,20,54
14,40,0.2264210283756256,0.7637795275590551,57,70,53,74,40,13,17,57
14,41,0.2017877697944641,0.7637795275590551,55,72,53,74,39,14,16,58
14,42,0.20242740213871002,0.7716535433070866,54,73,53,74,39,14,15,59
14,43,0.19781534373760223,0.7795275590551181,55,72,53,74,40,13,15,59
14,44,0.20691154897212982,0.7795275590551181,55,72,53,74,40,13,15,59
14,45,0.1929733157157898,0.7795275590551181,59,68,53,74,42,11,17,57
14,46,0.19258327782154083,0.7716535433070866,56,71,53,74,40,13,16,58
14,47,0.17355526983737946,0.7795275590551181,55,72,53,74,40,13,15,59
14,48,0.17716512084007263,0.7716535433070866,56,71,53,74,40,13,16,58
14,49,0.19589650630950928,0.7795275590551181,59,68,53,74,42,11,17,57
15,0,0.7138066291809082,0.41732283464566927,127,0,53,74,53,0,74,0
15,1,2.94915509223938,0.41732283464566927,127,0,53,74,53,0,74,0
15,2,0.9668115973472595,0.41732283464566927,127,0,53,74,53,0,74,0
15,3,0.685670793056488,0.5826771653543307,0,127,53,74,0,53,0,74
15,4,0.7833892703056335,0.5826771653543307,0,127,53,74,0,53,0,74
15,5,0.7823484539985657,0.5826771653543307,0,127,53,74,0,53,0,74
15,6,0.7582733035087585,0.5826771653543307,0,127,53,74,0,53,0,74
15,7,0.72689288854599,0.5826771653543307,0,127,53,74,0,53,0,74
15,8,0.688622236251831,0.5826771653543307,0,127,53,74,0,53,0,74
15,9,0.6743048429489136,0.5826771653543307,0,127,53,74,0,53,0,74
15,10,0.654813289642334,0.5826771653543307,0,127,53,74,0,53,0,74
15,11,0.6386173367500305,0.5826771653543307,0,127,53,74,0,53,0,74
15,12,0.6153971552848816,0.6692913385826772,15,112,53,74,13,40,2,72
15,13,0.594207763671875,0.7322834645669292,29,98,53,74,24,29,5,69
15,14,0.5724778771400452,0.7795275590551181,33,94,53,74,29,24,4,70
15,15,0.5600558519363403,0.7952755905511811,35,92,53,74,31,22,4,70
15,16,0.5377830862998962,0.7795275590551181,39,88,53,74,32,21,7,67
15,17,0.5158842206001282,0.7716535433070866,42,85,53,74,33,20,9,65
15,18,0.5039657950401306,0.7716535433070866,44,83,53,74,34,19,10,64
15,19,0.47354236245155334,0.7795275590551181,43,84,53,74,34,19,9,65
15,20,0.45862776041030884,0.7874015748031497,44,83,53,74,35,18,9,65
15,21,0.4402163624763489,0.7795275590551181,43,84,53,74,34,19,9,65
15,22,0.4194609224796295,0.7559055118110236,42,85,53,74,32,21,10,64
15,23,0.3906574845314026,0.7637795275590551,43,84,53,74,33,20,10,64
15,24,0.37402889132499695,0.7952755905511811,47,80,53,74,37,16,10,64
15,25,0.34715571999549866,0.8110236220472441,49,78,53,74,39,14,10,64
15,26,0.3432004451751709,0.8346456692913385,56,71,53,74,44,9,12,62
15,27,0.32882416248321533,0.8346456692913385,56,71,53,74,44,9,12,62
15,28,0.3202996253967285,0.8267716535433071,57,70,53,74,44,9,13,61
15,29,0.30341923236846924,0.8188976377952756,56,71,53,74,43,10,13,61
15,30,0.29067063331604004,0.8188976377952756,56,71,53,74,43,10,13,61
15,31,0.2796535789966583,0.8188976377952756,56,71,53,74,43,10,13,61
15,32,0.27669551968574524,0.8110236220472441,55,72,53,74,42,11,13,61
15,33,0.2627248167991638,0.8110236220472441,55,72,53,74,42,11,13,61
15,34,0.24681268632411957,0.8110236220472441,55,72,53,74,42,11,13,61
15,35,0.2472057044506073,0.8110236220472441,55,72,53,74,42,11,13,61
15,36,0.23331670463085175,0.8110236220472441,53,74,53,74,41,12,12,62
15,37,0.23114575445652008,0.8188976377952756,52,75,53,74,41,12,11,63
15,38,0.21224437654018402,0.8110236220472441,53,74,53,74,41,12,12,62
15,39,0.21655221283435822,0.8188976377952756,52,75,53,74,41,12,11,63
15,40,0.21758513152599335,0.8110236220472441,51,76,53,74,40,13,11,63
15,41,0.20057232677936554,0.8110236220472441,47,80,53,74,38,15,9,65
15,42,0.20238247513771057,0.7952755905511811,45,82,53,74,36,17,9,65
15,43,0.192209854722023,0.8110236220472441,45,82,53,74,37,16,8,66
15,44,0.19248972833156586,0.8031496062992126,44,83,53,74,36,17,8,66
15,45,0.19428390264511108,0.8031496062992126,44,83,53,74,36,17,8,66
15,46,0.19005721807479858,0.8110236220472441,43,84,53,74,36,17,7,67
15,47,0.1989133059978485,0.8031496062992126,46,81,53,74,37,16,9,65
15,48,0.1878858208656311,0.7952755905511811,49,78,53,74,38,15,11,63
15,49,0.20366738736629486,0.7952755905511811,51,76,53,74,39,14,12,62
