Fold,Epoch,Loss,Accuracy,Pred_Real,Pred_Fake,True_Real,True_Fake,TN,FP,FN,TP
1,0,0.7410137057304382,0.5859375,0,128,53,75,0,53,0,75
1,1,40.83966064453125,0.5859375,0,128,53,75,0,53,0,75
1,2,5.7466020584106445,0.3984375,104,24,53,75,40,13,64,11
1,3,0.7915152907371521,0.4609375,92,36,53,75,38,15,54,21
1,4,1.225340723991394,0.5078125,104,24,53,75,47,6,57,18
1,5,1.0061774253845215,0.546875,93,35,53,75,44,9,49,26
1,6,1.32033371925354,0.5625,79,49,53,75,38,15,41,34
1,7,0.7893093824386597,0.5234375,96,32,53,75,44,9,52,23
1,8,0.6496066451072693,0.515625,103,25,53,75,47,6,56,19
1,9,0.6302624940872192,0.5,107,21,53,75,48,5,59,16
1,10,0.5749906897544861,0.5,109,19,53,75,49,4,60,15
1,11,0.5545260906219482,0.5,111,17,53,75,50,3,61,14
1,12,0.5394588112831116,0.5078125,108,20,53,75,49,4,59,16
1,13,0.5032079219818115,0.5234375,106,22,53,75,49,4,57,18
1,14,0.48720696568489075,0.546875,103,25,53,75,49,4,54,21
1,15,0.4414388835430145,0.5625,101,27,53,75,49,4,52,23
1,16,0.40665125846862793,0.5859375,98,30,53,75,49,4,49,26
1,17,0.3810555934906006,0.625,93,35,53,75,49,4,44,31
1,18,0.42817991971969604,0.609375,95,33,53,75,49,4,46,29
1,19,0.45570108294487,0.640625,89,39,53,75,48,5,41,34
1,20,0.34373578429222107,0.703125,77,51,53,75,46,7,31,44
1,21,0.2837546467781067,0.7265625,68,60,53,75,43,10,25,50
1,22,0.3657666742801666,0.7421875,72,56,53,75,46,7,26,49
1,23,0.29003608226776123,0.7265625,74,54,53,75,46,7,28,47
1,24,0.2846262753009796,0.71875,75,53,53,75,46,7,29,46
1,25,0.3115784525871277,0.7265625,74,54,53,75,46,7,28,47
1,26,0.27897849678993225,0.7421875,68,60,53,75,44,9,24,51
1,27,0.24388228356838226,0.734375,61,67,53,75,40,13,21,54
1,28,0.2224748283624649,0.7265625,58,70,53,75,38,15,20,55
1,29,0.2456999570131302,0.7109375,56,72,53,75,36,17,20,55
1,30,0.21426615118980408,0.7265625,58,70,53,75,38,15,20,55
1,31,0.18721020221710205,0.7265625,58,70,53,75,38,15,20,55
1,32,0.1919754594564438,0.734375,59,69,53,75,39,14,20,55
1,33,0.1777995377779007,0.7265625,60,68,53,75,39,14,21,54
1,34,0.17278878390789032,0.7109375,58,70,53,75,37,16,21,54
1,35,0.1664988398551941,0.7109375,56,72,53,75,36,17,20,55
1,36,0.16903606057167053,0.71875,55,73,53,75,36,17,19,56
1,37,0.15216176211833954,0.7265625,52,76,53,75,35,18,17,58
1,38,0.13477139174938202,0.7265625,52,76,53,75,35,18,17,58
1,39,0.13056746125221252,0.71875,51,77,53,75,34,19,17,58
1,40,0.1404261589050293,0.7265625,52,76,53,75,35,18,17,58
1,41,0.13290046155452728,0.71875,53,75,53,75,35,18,18,57
1,42,0.12938888370990753,0.7265625,54,74,53,75,36,17,18,57
1,43,0.1408856064081192,0.7265625,52,76,53,75,35,18,17,58
1,44,0.10453019291162491,0.7265625,52,76,53,75,35,18,17,58
1,45,0.10944095999002457,0.7265625,52,76,53,75,35,18,17,58
1,46,0.10412681847810745,0.7265625,52,76,53,75,35,18,17,58
1,47,0.10415803641080856,0.7265625,52,76,53,75,35,18,17,58
1,48,0.10549744218587875,0.7265625,52,76,53,75,35,18,17,58
1,49,0.10520914942026138,0.7265625,52,76,53,75,35,18,17,58
2,0,0.7286573648452759,0.4094488188976378,127,0,52,75,52,0,75,0
2,1,41.085758209228516,0.4094488188976378,127,0,52,75,52,0,75,0
2,2,6.051574230194092,0.5905511811023622,0,127,52,75,0,52,0,75
2,3,3.1261703968048096,0.5905511811023622,0,127,52,75,0,52,0,75
2,4,2.798139810562134,0.5905511811023622,0,127,52,75,0,52,0,75
2,5,1.4764224290847778,0.5905511811023622,0,127,52,75,0,52,0,75
2,6,0.8455311059951782,0.6141732283464567,5,122,52,75,4,48,1,74
2,7,0.7383135557174683,0.6771653543307087,41,86,52,75,26,26,15,60
2,8,0.7810870409011841,0.6929133858267716,63,64,52,75,38,14,25,50
2,9,0.6306479573249817,0.6692913385826772,32,95,52,75,21,31,11,64
2,10,0.6394799947738647,0.6456692913385826,19,108,52,75,13,39,6,69
2,11,0.6313309073448181,0.6692913385826772,24,103,52,75,17,35,7,68
2,12,0.5702182650566101,0.7165354330708661,38,89,52,75,27,25,11,64
2,13,0.5463520288467407,0.7165354330708661,62,65,52,75,39,13,23,52
2,14,0.5604264736175537,0.7322834645669292,66,61,52,75,42,10,24,51
2,15,0.47873857617378235,0.7637795275590551,58,69,52,75,40,12,18,57
2,16,0.43380066752433777,0.7795275590551181,50,77,52,75,37,15,13,62
2,17,0.41458597779273987,0.7795275590551181,46,81,52,75,35,17,11,64
2,18,0.391506165266037,0.7874015748031497,27,100,52,75,26,26,1,74
2,19,0.4215976595878601,0.7952755905511811,40,87,52,75,33,19,7,68
2,20,0.40321436524391174,0.7874015748031497,27,100,52,75,26,26,1,74
2,21,0.3364947736263275,0.7322834645669292,18,109,52,75,18,34,0,75
2,22,0.34170493483543396,0.7322834645669292,18,109,52,75,18,34,0,75
2,23,0.2800136208534241,0.7637795275590551,22,105,52,75,22,30,0,75
2,24,0.25806930661201477,0.7874015748031497,25,102,52,75,25,27,0,75
2,25,0.2812650501728058,0.7795275590551181,24,103,52,75,24,28,0,75
2,26,0.26285815238952637,0.7401574803149606,19,108,52,75,19,33,0,75
2,27,0.22234830260276794,0.7401574803149606,19,108,52,75,19,33,0,75
2,28,0.2332640439271927,0.7716535433070866,23,104,52,75,23,29,0,75
2,29,0.18951471149921417,0.7952755905511811,28,99,52,75,27,25,1,74
2,30,0.20765969157218933,0.8188976377952756,33,94,52,75,31,21,2,73
2,31,0.19310395419597626,0.8267716535433071,34,93,52,75,32,20,2,73
2,32,0.17137329280376434,0.8267716535433071,34,93,52,75,32,20,2,73
2,33,0.17244842648506165,0.8267716535433071,34,93,52,75,32,20,2,73
2,34,0.1455322802066803,0.8188976377952756,35,92,52,75,32,20,3,72
2,35,0.13807524740695953,0.8031496062992126,37,90,52,75,32,20,5,70
2,36,0.14628219604492188,0.7952755905511811,38,89,52,75,32,20,6,69
2,37,0.1320294886827469,0.8110236220472441,40,87,52,75,34,18,6,69
2,38,0.10871927440166473,0.8267716535433071,42,85,52,75,36,16,6,69
2,39,0.11815470457077026,0.8267716535433071,42,85,52,75,36,16,6,69
2,40,0.10823214054107666,0.8267716535433071,42,85,52,75,36,16,6,69
2,41,0.1179620623588562,0.8267716535433071,42,85,52,75,36,16,6,69
2,42,0.08744225651025772,0.8267716535433071,44,83,52,75,37,15,7,68
2,43,0.08506973832845688,0.8267716535433071,44,83,52,75,37,15,7,68
2,44,0.08473037928342819,0.8346456692913385,43,84,52,75,37,15,6,69
2,45,0.09259110689163208,0.8267716535433071,40,87,52,75,35,17,5,70
2,46,0.07805076986551285,0.8188976377952756,39,88,52,75,34,18,5,70
2,47,0.07348522543907166,0.8188976377952756,41,86,52,75,35,17,6,69
2,48,0.08631090074777603,0.8188976377952756,41,86,52,75,35,17,6,69
2,49,0.061002787202596664,0.8188976377952756,41,86,52,75,35,17,6,69
3,0,0.7160900235176086,0.4094488188976378,127,0,52,75,52,0,75,0
3,1,37.183345794677734,0.4330708661417323,120,7,52,75,50,2,70,5
3,2,0.9473150372505188,0.5905511811023622,0,127,52,75,0,52,0,75
3,3,9.327005386352539,0.3858267716535433,122,5,52,75,48,4,74,1
3,4,3.4902420043945312,0.5905511811023622,0,127,52,75,0,52,0,75
3,5,2.1558895111083984,0.7637795275590551,66,61,52,75,44,8,22,53
3,6,0.7713907957077026,0.6456692913385826,91,36,52,75,49,3,42,33
3,7,0.775714635848999,0.8503937007874016,39,88,52,75,36,16,3,72
3,8,0.41668248176574707,0.6062992125984252,2,125,52,75,2,50,0,75
3,9,0.5879503488540649,0.6456692913385826,7,120,52,75,7,45,0,75
3,10,0.46130841970443726,0.84251968503937,38,89,52,75,35,17,3,72
3,11,0.3464336395263672,0.8267716535433071,58,69,52,75,44,8,14,61
3,12,0.46594250202178955,0.8740157480314961,48,79,52,75,42,10,6,69
3,13,0.3687598407268524,0.7952755905511811,26,101,52,75,26,26,0,75
3,14,0.30152997374534607,0.6614173228346457,9,118,52,75,9,43,0,75
3,15,0.36020156741142273,0.6456692913385826,7,120,52,75,7,45,0,75
3,16,0.34216561913490295,0.6929133858267716,13,114,52,75,13,39,0,75
3,17,0.3175937235355377,0.8188976377952756,29,98,52,75,29,23,0,75
3,18,0.25903841853141785,0.8346456692913385,41,86,52,75,36,16,5,70
3,19,0.2810753881931305,0.8346456692913385,41,86,52,75,36,16,5,70
3,20,0.2934153974056244,0.8031496062992126,35,92,52,75,31,21,4,71
3,21,0.25100085139274597,0.7559055118110236,23,104,52,75,22,30,1,74
3,22,0.2082027941942215,0.7086614173228346,15,112,52,75,15,37,0,75
3,23,0.2298063039779663,0.7007874015748031,14,113,52,75,14,38,0,75
3,24,0.27338916063308716,0.7637795275590551,26,101,52,75,24,28,2,73
3,25,0.19838833808898926,0.8346456692913385,39,88,52,75,35,17,4,71
3,26,0.20931415259838104,0.84251968503937,42,85,52,75,37,15,5,70
3,27,0.21567663550376892,0.8582677165354331,44,83,52,75,39,13,5,70
3,28,0.18695068359375,0.84251968503937,40,87,52,75,36,16,4,71
3,29,0.16282880306243896,0.8267716535433071,38,89,52,75,34,18,4,71
3,30,0.14704734086990356,0.8346456692913385,35,92,52,75,33,19,2,73
3,31,0.15452420711517334,0.8346456692913385,35,92,52,75,33,19,2,73
3,32,0.15218289196491241,0.8267716535433071,38,89,52,75,34,18,4,71
3,33,0.16152331233024597,0.84251968503937,44,83,52,75,38,14,6,69
3,34,0.12716364860534668,0.8503937007874016,49,78,52,75,41,11,8,67
3,35,0.1317174732685089,0.8503937007874016,53,74,52,75,43,9,10,65
3,36,0.1340879648923874,0.8582677165354331,54,73,52,75,44,8,10,65
3,37,0.1183166652917862,0.8503937007874016,51,76,52,75,42,10,9,66
3,38,0.10781838744878769,0.8503937007874016,49,78,52,75,41,11,8,67
3,39,0.10584919154644012,0.8740157480314961,46,81,52,75,41,11,5,70
3,40,0.09977938234806061,0.8503937007874016,49,78,52,75,41,11,8,67
3,41,0.09815604984760284,0.8661417322834646,53,74,52,75,44,8,9,66
3,42,0.09155149757862091,0.8661417322834646,57,70,52,75,46,6,11,64
3,43,0.09270568192005157,0.8661417322834646,57,70,52,75,46,6,11,64
3,44,0.08369407802820206,0.8661417322834646,59,68,52,75,47,5,12,63
3,45,0.08586317300796509,0.8740157480314961,60,67,52,75,48,4,12,63
3,46,0.1033627912402153,0.8740157480314961,60,67,52,75,48,4,12,63
3,47,0.09540923684835434,0.8661417322834646,55,72,52,75,45,7,10,65
3,48,0.07632380723953247,0.8661417322834646,55,72,52,75,45,7,10,65
3,49,0.07255696505308151,0.8661417322834646,55,72,52,75,45,7,10,65
4,0,0.7220513224601746,0.4094488188976378,127,0,52,75,52,0,75,0
4,1,41.17390441894531,0.4094488188976378,127,0,52,75,52,0,75,0
4,2,8.034769058227539,0.5905511811023622,0,127,52,75,0,52,0,75
4,3,1.9313454627990723,0.5039370078740157,13,114,52,75,1,51,12,63
4,4,2.1751883029937744,0.5826771653543307,1,126,52,75,0,52,1,74
4,5,1.3021519184112549,0.5669291338582677,5,122,52,75,1,51,4,71
4,6,0.8498017191886902,0.4251968503937008,33,94,52,75,6,46,27,48
4,7,0.7760949730873108,0.5275590551181102,44,83,52,75,18,34,26,49
4,8,0.9820532202720642,0.6614173228346457,63,64,52,75,36,16,27,48
4,9,0.774356484413147,0.7086614173228346,55,72,52,75,35,17,20,55
4,10,0.6696856617927551,0.6771653543307087,19,108,52,75,15,37,4,71
4,11,0.6267524361610413,0.5984251968503937,3,124,52,75,2,50,1,74
4,12,0.6169967651367188,0.5905511811023622,2,125,52,75,1,51,1,74
4,13,0.5989773273468018,0.5984251968503937,1,126,52,75,1,51,0,75
4,14,0.5725127458572388,0.5984251968503937,3,124,52,75,2,50,1,74
4,15,0.5330448150634766,0.6299212598425197,11,116,52,75,8,44,3,72
4,16,0.4971843659877777,0.6850393700787402,20,107,52,75,16,36,4,71
4,17,0.5076126456260681,0.7007874015748031,24,103,52,75,19,33,5,70
4,18,0.46471360325813293,0.7165354330708661,24,103,52,75,20,32,4,71
4,19,0.4393819272518158,0.7165354330708661,24,103,52,75,20,32,4,71
4,20,0.4490491449832916,0.7165354330708661,24,103,52,75,20,32,4,71
4,21,0.399017870426178,0.7401574803149606,29,98,52,75,24,28,5,70
4,22,0.3886438012123108,0.7559055118110236,35,92,52,75,28,24,7,68
4,23,0.38088178634643555,0.7795275590551181,36,91,52,75,30,22,6,69
4,24,0.3545128107070923,0.7795275590551181,36,91,52,75,30,22,6,69
4,25,0.3333969712257385,0.7716535433070866,37,90,52,75,30,22,7,68
4,26,0.3369016647338867,0.7716535433070866,43,84,52,75,33,19,10,65
4,27,0.3011186718940735,0.8267716535433071,54,73,52,75,42,10,12,63
4,28,0.28676292300224304,0.7874015748031497,59,68,52,75,42,10,17,58
4,29,0.26493039727211,0.7874015748031497,55,72,52,75,40,12,15,60
4,30,0.2662232518196106,0.7952755905511811,52,75,52,75,39,13,13,62
4,31,0.24529115855693817,0.7795275590551181,52,75,52,75,38,14,14,61
4,32,0.2356623113155365,0.7874015748031497,53,74,52,75,39,13,14,61
4,33,0.2219935655593872,0.7795275590551181,54,73,52,75,39,13,15,60
4,34,0.2063940465450287,0.7716535433070866,63,64,52,75,43,9,20,55
4,35,0.20398670434951782,0.7874015748031497,63,64,52,75,44,8,19,56
4,36,0.20214053988456726,0.7795275590551181,60,67,52,75,42,10,18,57
4,37,0.1777942180633545,0.7952755905511811,54,73,52,75,40,12,14,61
4,38,0.16988487541675568,0.8031496062992126,55,72,52,75,41,11,14,61
4,39,0.17854748666286469,0.7874015748031497,61,66,52,75,43,9,18,57
4,40,0.1542752981185913,0.7874015748031497,65,62,52,75,45,7,20,55
4,41,0.13861478865146637,0.7874015748031497,65,62,52,75,45,7,20,55
4,42,0.12511123716831207,0.7716535433070866,67,60,52,75,45,7,22,53
4,43,0.13073207437992096,0.7795275590551181,66,61,52,75,45,7,21,54
4,44,0.12375174462795258,0.7716535433070866,65,62,52,75,44,8,21,54
4,45,0.13167935609817505,0.7716535433070866,65,62,52,75,44,8,21,54
4,46,0.12505429983139038,0.7795275590551181,64,63,52,75,44,8,20,55
4,47,0.11939233541488647,0.7716535433070866,65,62,52,75,44,8,21,54
4,48,0.11158224195241928,0.7874015748031497,63,64,52,75,44,8,19,56
4,49,0.10954733192920685,0.8031496062992126,61,66,52,75,44,8,17,58
5,0,0.7737559080123901,0.5905511811023622,0,127,52,75,0,52,0,75
5,1,40.70413589477539,0.5905511811023622,0,127,52,75,0,52,0,75
5,2,5.941496849060059,0.5748031496062992,2,125,52,75,0,52,2,73
5,3,0.7203258872032166,0.4409448818897638,101,26,52,75,41,11,60,15
5,4,1.355331540107727,0.41732283464566927,126,1,52,75,52,0,74,1
5,5,1.3887048959732056,0.41732283464566927,126,1,52,75,52,0,74,1
5,6,1.0721535682678223,0.4251968503937008,125,2,52,75,52,0,73,2
5,7,0.8287754654884338,0.4566929133858268,119,8,52,75,51,1,68,7
5,8,0.7029995322227478,0.49606299212598426,110,17,52,75,49,3,61,14
5,9,0.6952193975448608,0.4881889763779528,87,40,52,75,37,15,50,25
5,10,0.6728056073188782,0.5118110236220472,80,47,52,75,35,17,45,30
5,11,0.6463106870651245,0.5118110236220472,80,47,52,75,35,17,45,30
5,12,0.6191329956054688,0.5275590551181102,90,37,52,75,41,11,49,26
5,13,0.5970775485038757,0.5590551181102362,94,33,52,75,45,7,49,26
5,14,0.5690377950668335,0.5590551181102362,96,31,52,75,46,6,50,25
5,15,0.5463734269142151,0.5590551181102362,96,31,52,75,46,6,50,25
5,16,0.5247738361358643,0.5748031496062992,96,31,52,75,47,5,49,26
5,17,0.49389082193374634,0.5826771653543307,93,34,52,75,46,6,47,28
5,18,0.473987877368927,0.6220472440944882,88,39,52,75,46,6,42,33
5,19,0.4517355263233185,0.6062992125984252,86,41,52,75,44,8,42,33
5,20,0.41920799016952515,0.6377952755905512,82,45,52,75,44,8,38,37
5,21,0.4104061424732208,0.6614173228346457,79,48,52,75,44,8,35,40
5,22,0.38478392362594604,0.6692913385826772,78,49,52,75,44,8,34,41
5,23,0.37498149275779724,0.6850393700787402,78,49,52,75,45,7,33,42
5,24,0.3281082808971405,0.7007874015748031,76,51,52,75,45,7,31,44
5,25,0.3647933006286621,0.7480314960629921,68,59,52,75,44,8,24,51
5,26,0.34515348076820374,0.7637795275590551,68,59,52,75,45,7,23,52
5,27,0.31431061029434204,0.7637795275590551,68,59,52,75,45,7,23,52
5,28,0.3288497030735016,0.7637795275590551,66,61,52,75,44,8,22,53
5,29,0.27100786566734314,0.7716535433070866,65,62,52,75,44,8,21,54
5,30,0.27444833517074585,0.7716535433070866,61,66,52,75,42,10,19,56
5,31,0.2928580939769745,0.7795275590551181,60,67,52,75,42,10,18,57
5,32,0.2505546510219574,0.7716535433070866,61,66,52,75,42,10,19,56
5,33,0.2466762512922287,0.7716535433070866,59,68,52,75,41,11,18,57
5,34,0.23159514367580414,0.7716535433070866,59,68,52,75,41,11,18,57
5,35,0.2226688116788864,0.7795275590551181,58,69,52,75,41,11,17,58
5,36,0.22248220443725586,0.8031496062992126,55,72,52,75,41,11,14,61
5,37,0.20478540658950806,0.7952755905511811,56,71,52,75,41,11,15,60
5,38,0.19476501643657684,0.8031496062992126,55,72,52,75,41,11,14,61
5,39,0.19730126857757568,0.7874015748031497,57,70,52,75,41,11,16,59
5,40,0.18540750443935394,0.7952755905511811,58,69,52,75,42,10,16,59
5,41,0.18333588540554047,0.7795275590551181,62,65,52,75,43,9,19,56
5,42,0.1728779673576355,0.7795275590551181,62,65,52,75,43,9,19,56
5,43,0.17529211938381195,0.8031496062992126,59,68,52,75,43,9,16,59
5,44,0.16333134472370148,0.7795275590551181,56,71,52,75,40,12,16,59
5,45,0.1696077138185501,0.7637795275590551,48,79,52,75,35,17,13,62
5,46,0.14996260404586792,0.7952755905511811,44,83,52,75,35,17,9,66
5,47,0.15915946662425995,0.7874015748031497,45,82,52,75,35,17,10,65
5,48,0.1632566899061203,0.7716535433070866,47,80,52,75,35,17,12,63
5,49,0.15508659183979034,0.7874015748031497,51,76,52,75,38,14,13,62
6,0,0.7860217094421387,0.5905511811023622,0,127,52,75,0,52,0,75
6,1,42.756507873535156,0.5905511811023622,0,127,52,75,0,52,0,75
6,2,9.36532211303711,0.4094488188976378,127,0,52,75,52,0,75,0
6,3,1.2985602617263794,0.4094488188976378,97,30,52,75,37,15,60,15
6,4,1.939028024673462,0.4094488188976378,127,0,52,75,52,0,75,0
6,5,1.7775566577911377,0.4094488188976378,127,0,52,75,52,0,75,0
6,6,1.234665036201477,0.4094488188976378,125,2,52,75,51,1,74,1
6,7,0.8339741230010986,0.4645669291338583,116,11,52,75,50,2,66,9
6,8,0.720754086971283,0.5354330708661418,105,22,52,75,49,3,56,19
6,9,0.7479067444801331,0.6062992125984252,84,43,52,75,43,9,41,34
6,10,0.7124552726745605,0.6062992125984252,80,47,52,75,41,11,39,36
6,11,0.6847184300422668,0.5905511811023622,94,33,52,75,47,5,47,28
6,12,0.5807349681854248,0.5748031496062992,96,31,52,75,47,5,49,26
6,13,0.5284785032272339,0.5590551181102362,102,25,52,75,49,3,53,22
6,14,0.4952920377254486,0.5511811023622047,105,22,52,75,50,2,55,20
6,15,0.5041711926460266,0.5590551181102362,104,23,52,75,50,2,54,21
6,16,0.5038188695907593,0.5748031496062992,102,25,52,75,50,2,52,23
6,17,0.46539732813835144,0.5826771653543307,101,26,52,75,50,2,51,24
6,18,0.4439058303833008,0.6299212598425197,95,32,52,75,50,2,45,30
6,19,0.41996750235557556,0.6850393700787402,88,39,52,75,50,2,38,37
6,20,0.4021499454975128,0.6771653543307087,85,42,52,75,48,4,37,38
6,21,0.40090668201446533,0.6771653543307087,85,42,52,75,48,4,37,38
6,22,0.3683411180973053,0.6771653543307087,85,42,52,75,48,4,37,38
6,23,0.3564852178096771,0.6692913385826772,88,39,52,75,49,3,39,36
6,24,0.3356626331806183,0.6377952755905512,92,35,52,75,49,3,43,32
6,25,0.32139530777931213,0.6299212598425197,93,34,52,75,49,3,44,31
6,26,0.3131962716579437,0.6377952755905512,96,31,52,75,51,1,45,30
6,27,0.2946357727050781,0.6377952755905512,96,31,52,75,51,1,45,30
6,28,0.317501425743103,0.6377952755905512,92,35,52,75,49,3,43,32
6,29,0.32572224736213684,0.6771653543307087,87,40,52,75,49,3,38,37
6,30,0.2638985514640808,0.7007874015748031,82,45,52,75,48,4,34,41
6,31,0.269535094499588,0.7322834645669292,76,51,52,75,47,5,29,46
6,32,0.27057045698165894,0.7401574803149606,77,50,52,75,48,4,29,46
6,33,0.2494649738073349,0.7401574803149606,77,50,52,75,48,4,29,46
6,34,0.21826043725013733,0.7322834645669292,78,49,52,75,48,4,30,45
6,35,0.23364992439746857,0.7244094488188977,77,50,52,75,47,5,30,45
6,36,0.21379300951957703,0.7165354330708661,78,49,52,75,47,5,31,44
6,37,0.26675480604171753,0.7165354330708661,78,49,52,75,47,5,31,44
6,38,0.20071980357170105,0.7165354330708661,78,49,52,75,47,5,31,44
6,39,0.21204786002635956,0.7244094488188977,77,50,52,75,47,5,30,45
6,40,0.21386133134365082,0.7322834645669292,76,51,52,75,47,5,29,46
6,41,0.20183835923671722,0.7322834645669292,76,51,52,75,47,5,29,46
6,42,0.18856829404830933,0.7322834645669292,76,51,52,75,47,5,29,46
6,43,0.17680878937244415,0.7559055118110236,73,54,52,75,47,5,26,49
6,44,0.1745985746383667,0.7401574803149606,75,52,52,75,47,5,28,47
6,45,0.18493637442588806,0.7401574803149606,75,52,52,75,47,5,28,47
6,46,0.1770557165145874,0.7401574803149606,75,52,52,75,47,5,28,47
6,47,0.16002149879932404,0.7480314960629921,74,53,52,75,47,5,27,48
6,48,0.16551817953586578,0.7480314960629921,74,53,52,75,47,5,27,48
6,49,0.15317325294017792,0.7559055118110236,73,54,52,75,47,5,26,49
7,0,0.7144795060157776,0.4094488188976378,127,0,52,75,52,0,75,0
7,1,31.41774559020996,0.5905511811023622,0,127,52,75,0,52,0,75
7,2,5.814518451690674,0.5905511811023622,0,127,52,75,0,52,0,75
7,3,1.288731575012207,0.41732283464566927,126,1,52,75,52,0,74,1
7,4,3.5727288722991943,0.8110236220472441,48,79,52,75,38,14,10,65
7,5,0.5678617358207703,0.5905511811023622,0,127,52,75,0,52,0,75
7,6,1.869046688079834,0.48031496062992124,116,11,52,75,51,1,65,10
7,7,0.6152255535125732,0.4566929133858268,121,6,52,75,52,0,69,6
7,8,0.9536116123199463,0.49606299212598426,116,11,52,75,52,0,64,11
7,9,0.9113739132881165,0.5039370078740157,111,16,52,75,50,2,61,14
7,10,0.6766526103019714,0.6220472440944882,94,33,52,75,49,3,45,30
7,11,0.4852595627307892,0.7244094488188977,77,50,52,75,47,5,30,45
7,12,0.39662855863571167,0.8031496062992126,65,62,52,75,46,6,19,56
7,13,0.4033423662185669,0.8188976377952756,63,64,52,75,46,6,17,58
7,14,0.37637901306152344,0.8110236220472441,64,63,52,75,46,6,18,57
7,15,0.2869969308376312,0.7874015748031497,67,60,52,75,46,6,21,54
7,16,0.21834495663642883,0.7244094488188977,79,48,52,75,48,4,31,44
7,17,0.21572762727737427,0.6771653543307087,87,40,52,75,49,3,38,37
7,18,0.22036758065223694,0.6771653543307087,89,38,52,75,50,2,39,36
7,19,0.26818251609802246,0.6929133858267716,85,42,52,75,49,3,36,39
7,20,0.20222657918930054,0.7637795275590551,76,51,52,75,49,3,27,48
7,21,0.20279569923877716,0.7952755905511811,66,61,52,75,46,6,20,55
7,22,0.17344439029693604,0.8110236220472441,64,63,52,75,46,6,18,57
7,23,0.177862748503685,0.8188976377952756,63,64,52,75,46,6,17,58
7,24,0.19540171325206757,0.8110236220472441,64,63,52,75,46,6,18,57
7,25,0.15515321493148804,0.7874015748031497,69,58,52,75,47,5,22,53
7,26,0.12518423795700073,0.7716535433070866,73,54,52,75,48,4,25,50
7,27,0.13928356766700745,0.7401574803149606,79,48,52,75,49,3,30,45
7,28,0.11197243630886078,0.7165354330708661,82,45,52,75,49,3,33,42
7,29,0.13277801871299744,0.7480314960629921,78,49,52,75,49,3,29,46
7,30,0.12792126834392548,0.7874015748031497,73,54,52,75,49,3,24,51
7,31,0.10426347702741623,0.7952755905511811,72,55,52,75,49,3,23,52
7,32,0.09931808710098267,0.8267716535433071,66,61,52,75,48,4,18,57
7,33,0.08968869596719742,0.8188976377952756,61,66,52,75,45,7,16,59
7,34,0.08892178535461426,0.8188976377952756,61,66,52,75,45,7,16,59
7,35,0.08911777287721634,0.8188976377952756,61,66,52,75,45,7,16,59
7,36,0.0847863256931305,0.8267716535433071,60,67,52,75,45,7,15,60
7,37,0.08348637074232101,0.8267716535433071,60,67,52,75,45,7,15,60
7,38,0.08200813084840775,0.8267716535433071,60,67,52,75,45,7,15,60
7,39,0.08270596712827682,0.8188976377952756,61,66,52,75,45,7,16,59
7,40,0.0823964923620224,0.8267716535433071,62,65,52,75,46,6,16,59
7,41,0.07355828583240509,0.8188976377952756,63,64,52,75,46,6,17,58
7,42,0.06230349838733673,0.8031496062992126,65,62,52,75,46,6,19,56
7,43,0.07561897486448288,0.8110236220472441,66,61,52,75,47,5,19,56
7,44,0.05424374341964722,0.8110236220472441,66,61,52,75,47,5,19,56
7,45,0.06464055925607681,0.8031496062992126,65,62,52,75,46,6,19,56
7,46,0.05926165729761124,0.8031496062992126,61,66,52,75,44,8,17,58
7,47,0.06867264211177826,0.8031496062992126,61,66,52,75,44,8,17,58
7,48,0.05328209325671196,0.7952755905511811,58,69,52,75,42,10,16,59
7,49,0.05043996125459671,0.7952755905511811,56,71,52,75,41,11,15,60
8,0,0.7955671548843384,0.4094488188976378,127,0,52,75,52,0,75,0
8,1,39.91016387939453,0.4094488188976378,127,0,52,75,52,0,75,0
8,2,8.688573837280273,0.5905511811023622,0,127,52,75,0,52,0,75
8,3,0.8354771733283997,0.5748031496062992,2,125,52,75,0,52,2,73
8,4,1.7996450662612915,0.5748031496062992,4,123,52,75,1,51,3,72
8,5,1.420499563217163,0.5984251968503937,5,122,52,75,3,49,2,73
8,6,0.9893208146095276,0.5748031496062992,12,115,52,75,5,47,7,68
8,7,0.7226365208625793,0.5748031496062992,32,95,52,75,15,37,17,58
8,8,0.6980570554733276,0.5511811023622047,47,80,52,75,21,31,26,49
8,9,0.6947542428970337,0.5275590551181102,52,75,52,75,22,30,30,45
8,10,0.6487016677856445,0.5826771653543307,45,82,52,75,22,30,23,52
8,11,0.6222966313362122,0.6456692913385826,25,102,52,75,16,36,9,66
8,12,0.5828505158424377,0.6062992125984252,22,105,52,75,12,40,10,65
8,13,0.5496207475662231,0.5905511811023622,10,117,52,75,5,47,5,70
8,14,0.5149366855621338,0.5826771653543307,5,122,52,75,2,50,3,72
8,15,0.44947585463523865,0.5905511811023622,4,123,52,75,2,50,2,73
8,16,0.468708336353302,0.5748031496062992,6,121,52,75,2,50,4,71
8,17,0.428698867559433,0.5669291338582677,7,120,52,75,2,50,5,70
8,18,0.4163011908531189,0.5669291338582677,7,120,52,75,2,50,5,70
8,19,0.3918515741825104,0.5748031496062992,8,119,52,75,3,49,5,70
8,20,0.3545067012310028,0.5748031496062992,8,119,52,75,3,49,5,70
8,21,0.3484470844268799,0.5826771653543307,9,118,52,75,4,48,5,70
8,22,0.3226836025714874,0.6220472440944882,14,113,52,75,9,43,5,70
8,23,0.29057779908180237,0.6535433070866141,18,109,52,75,13,39,5,70
8,24,0.2904737591743469,0.6614173228346457,27,100,52,75,18,34,9,66
8,25,0.2965151071548462,0.6692913385826772,22,105,52,75,16,36,6,69
8,26,0.2624570429325104,0.6692913385826772,22,105,52,75,16,36,6,69
8,27,0.25845596194267273,0.6850393700787402,26,101,52,75,19,33,7,68
8,28,0.2388116717338562,0.7007874015748031,32,95,52,75,23,29,9,66
8,29,0.2230573296546936,0.7086614173228346,33,94,52,75,24,28,9,66
8,30,0.21573233604431152,0.7007874015748031,30,97,52,75,22,30,8,67
8,31,0.2005603164434433,0.7007874015748031,30,97,52,75,22,30,8,67
8,32,0.2047175168991089,0.7086614173228346,31,96,52,75,23,29,8,67
8,33,0.1982085257768631,0.6771653543307087,27,100,52,75,19,33,8,67
8,34,0.2039206176996231,0.6850393700787402,28,99,52,75,20,32,8,67
8,35,0.1953783929347992,0.6929133858267716,31,96,52,75,22,30,9,66
8,36,0.1553458720445633,0.6929133858267716,31,96,52,75,22,30,9,66
8,37,0.16747525334358215,0.7007874015748031,32,95,52,75,23,29,9,66
8,38,0.15172365307807922,0.7007874015748031,32,95,52,75,23,29,9,66
8,39,0.14915427565574646,0.7007874015748031,32,95,52,75,23,29,9,66
8,40,0.14737331867218018,0.6771653543307087,29,98,52,75,20,32,9,66
8,41,0.13505718111991882,0.6850393700787402,28,99,52,75,20,32,8,67
8,42,0.14088651537895203,0.7007874015748031,28,99,52,75,21,31,7,68
8,43,0.129991352558136,0.6929133858267716,31,96,52,75,22,30,9,66
8,44,0.12062016874551773,0.7007874015748031,30,97,52,75,22,30,8,67
8,45,0.1351260542869568,0.7086614173228346,27,100,52,75,21,31,6,69
8,46,0.12368478626012802,0.7165354330708661,26,101,52,75,21,31,5,70
8,47,0.11101239174604416,0.7086614173228346,25,102,52,75,20,32,5,70
8,48,0.11199197918176651,0.7244094488188977,27,100,52,75,22,30,5,70
8,49,0.1111285462975502,0.7244094488188977,27,100,52,75,22,30,5,70
9,0,0.8011721968650818,0.4094488188976378,127,0,52,75,52,0,75,0
9,1,41.279903411865234,0.4094488188976378,127,0,52,75,52,0,75,0
9,2,9.524933815002441,0.5905511811023622,0,127,52,75,0,52,0,75
9,3,0.9679126739501953,0.5433070866141733,6,121,52,75,0,52,6,69
9,4,1.8557839393615723,0.4566929133858268,37,90,52,75,10,42,27,48
9,5,1.320862889289856,0.5196850393700787,51,76,52,75,21,31,30,45
9,6,0.8202969431877136,0.5826771653543307,69,58,52,75,34,18,35,40
9,7,0.8995575308799744,0.6771653543307087,71,56,52,75,41,11,30,45
9,8,0.7538127303123474,0.7244094488188977,61,66,52,75,39,13,22,53
9,9,0.6472039818763733,0.6692913385826772,38,89,52,75,24,28,14,61
9,10,0.5779845118522644,0.6771653543307087,19,108,52,75,15,37,4,71
9,11,0.5471760034561157,0.6456692913385826,11,116,52,75,9,43,2,73
9,12,0.5779586434364319,0.6535433070866141,10,117,52,75,9,43,1,74
9,13,0.513437807559967,0.6456692913385826,9,118,52,75,8,44,1,74
9,14,0.4688320755958557,0.6535433070866141,10,117,52,75,9,43,1,74
9,15,0.47558093070983887,0.6692913385826772,12,115,52,75,11,41,1,74
9,16,0.4330826997756958,0.6771653543307087,11,116,52,75,11,41,0,75
9,17,0.4008246660232544,0.6771653543307087,11,116,52,75,11,41,0,75
9,18,0.38592690229415894,0.6692913385826772,12,115,52,75,11,41,1,74
9,19,0.3681168258190155,0.6771653543307087,13,114,52,75,12,40,1,74
9,20,0.341739296913147,0.6929133858267716,15,112,52,75,14,38,1,74
9,21,0.34342095255851746,0.7007874015748031,16,111,52,75,15,37,1,74
9,22,0.32280489802360535,0.7007874015748031,16,111,52,75,15,37,1,74
9,23,0.31161367893218994,0.7007874015748031,16,111,52,75,15,37,1,74
9,24,0.30131763219833374,0.7165354330708661,18,109,52,75,17,35,1,74
9,25,0.27489596605300903,0.7165354330708661,18,109,52,75,17,35,1,74
9,26,0.28691941499710083,0.7401574803149606,21,106,52,75,20,32,1,74
9,27,0.274355411529541,0.7401574803149606,23,104,52,75,21,31,2,73
9,28,0.2628694772720337,0.7480314960629921,24,103,52,75,22,30,2,73
9,29,0.25051796436309814,0.7559055118110236,25,102,52,75,23,29,2,73
9,30,0.25683847069740295,0.7637795275590551,28,99,52,75,25,27,3,72
9,31,0.22491788864135742,0.7716535433070866,29,98,52,75,26,26,3,72
9,32,0.2375362068414688,0.7952755905511811,34,93,52,75,30,22,4,71
9,33,0.23082579672336578,0.7952755905511811,32,95,52,75,29,23,3,72
9,34,0.2094746232032776,0.7795275590551181,30,97,52,75,27,25,3,72
9,35,0.20945850014686584,0.7716535433070866,29,98,52,75,26,26,3,72
9,36,0.1961318552494049,0.7952755905511811,30,97,52,75,28,24,2,73
9,37,0.17484113574028015,0.8188976377952756,35,92,52,75,32,20,3,72
9,38,0.1814676821231842,0.8267716535433071,34,93,52,75,32,20,2,73
9,39,0.18687234818935394,0.8267716535433071,34,93,52,75,32,20,2,73
9,40,0.17152473330497742,0.8267716535433071,34,93,52,75,32,20,2,73
9,41,0.16271895170211792,0.8188976377952756,33,94,52,75,31,21,2,73
9,42,0.14444607496261597,0.8110236220472441,32,95,52,75,30,22,2,73
9,43,0.15646129846572876,0.8031496062992126,31,96,52,75,29,23,2,73
9,44,0.1442808359861374,0.8031496062992126,31,96,52,75,29,23,2,73
9,45,0.1512959897518158,0.8110236220472441,32,95,52,75,30,22,2,73
9,46,0.14082615077495575,0.8110236220472441,32,95,52,75,30,22,2,73
9,47,0.13239800930023193,0.8031496062992126,31,96,52,75,29,23,2,73
9,48,0.11580448597669601,0.8031496062992126,31,96,52,75,29,23,2,73
9,49,0.12226571887731552,0.7952755905511811,30,97,52,75,28,24,2,73
10,0,0.7676199674606323,0.4094488188976378,127,0,52,75,52,0,75,0
10,1,43.17170333862305,0.4094488188976378,127,0,52,75,52,0,75,0
10,2,10.403607368469238,0.5905511811023622,0,127,52,75,0,52,0,75
10,3,1.5152587890625,0.5905511811023622,0,127,52,75,0,52,0,75
10,4,2.146667718887329,0.5826771653543307,3,124,52,75,1,51,2,73
10,5,1.3994982242584229,0.7165354330708661,38,89,52,75,27,25,11,64
10,6,0.8324543237686157,0.5196850393700787,91,36,52,75,41,11,50,25
10,7,1.1825846433639526,0.5039370078740157,113,14,52,75,51,1,62,13
10,8,0.8647258281707764,0.5275590551181102,104,23,52,75,48,4,56,19
10,9,0.6280851364135742,0.7007874015748031,70,57,52,75,42,10,28,47
10,10,0.596737802028656,0.7244094488188977,35,92,52,75,26,26,9,66
10,11,0.5962086319923401,0.7322834645669292,20,107,52,75,19,33,1,74
10,12,0.5490090847015381,0.7086614173228346,17,110,52,75,16,36,1,74
10,13,0.5528857707977295,0.6929133858267716,13,114,52,75,13,39,0,75
10,14,0.4782092571258545,0.6929133858267716,13,114,52,75,13,39,0,75
10,15,0.4777495861053467,0.7165354330708661,18,109,52,75,17,35,1,74
10,16,0.4431529939174652,0.7637795275590551,26,101,52,75,24,28,2,73
10,17,0.4405038356781006,0.7795275590551181,30,97,52,75,27,25,3,72
10,18,0.4094855487346649,0.7795275590551181,34,93,52,75,29,23,5,70
10,19,0.3919670879840851,0.8031496062992126,35,92,52,75,31,21,4,71
10,20,0.357394278049469,0.8031496062992126,37,90,52,75,32,20,5,70
10,21,0.3490859568119049,0.8188976377952756,39,88,52,75,34,18,5,70
10,22,0.32726919651031494,0.8110236220472441,50,77,52,75,39,13,11,64
10,23,0.3246227204799652,0.8110236220472441,50,77,52,75,39,13,11,64
10,24,0.3046773672103882,0.8346456692913385,45,82,52,75,38,14,7,68
10,25,0.2798616290092468,0.8188976377952756,33,94,52,75,31,21,2,73
10,26,0.29481860995292664,0.8346456692913385,43,84,52,75,37,15,6,69
10,27,0.2507619857788086,0.7952755905511811,54,73,52,75,40,12,14,61
10,28,0.2836362421512604,0.8188976377952756,55,72,52,75,42,10,13,62
10,29,0.24425573647022247,0.8503937007874016,47,80,52,75,40,12,7,68
10,30,0.2134338915348053,0.8582677165354331,42,85,52,75,38,14,4,71
10,31,0.22531871497631073,0.8661417322834646,43,84,52,75,39,13,4,71
10,32,0.20298531651496887,0.8740157480314961,44,83,52,75,40,12,4,71
10,33,0.20587708055973053,0.8188976377952756,55,72,52,75,42,10,13,62
10,34,0.21556563675403595,0.8267716535433071,56,71,52,75,43,9,13,62
10,35,0.1841006875038147,0.84251968503937,50,77,52,75,41,11,9,66
10,36,0.1854075789451599,0.8582677165354331,48,79,52,75,41,11,7,68
10,37,0.1609066277742386,0.8346456692913385,51,76,52,75,41,11,10,65
10,38,0.16105742752552032,0.84251968503937,52,75,52,75,42,10,10,65
10,39,0.1497681438922882,0.84251968503937,54,73,52,75,43,9,11,64
10,40,0.14324170351028442,0.8346456692913385,55,72,52,75,43,9,12,63
10,41,0.1525651514530182,0.8346456692913385,55,72,52,75,43,9,12,63
10,42,0.13158653676509857,0.8346456692913385,55,72,52,75,43,9,12,63
10,43,0.13039530813694,0.8346456692913385,55,72,52,75,43,9,12,63
10,44,0.1299600899219513,0.8267716535433071,56,71,52,75,43,9,13,62
10,45,0.117475725710392,0.8267716535433071,56,71,52,75,43,9,13,62
10,46,0.10770104080438614,0.8267716535433071,54,73,52,75,42,10,12,63
10,47,0.11325865238904953,0.84251968503937,52,75,52,75,42,10,10,65
10,48,0.10914315283298492,0.8267716535433071,52,75,52,75,41,11,11,64
10,49,0.09859426319599152,0.8110236220472441,52,75,52,75,40,12,12,63
11,0,0.9111759662628174,0.5905511811023622,0,127,52,75,0,52,0,75
11,1,38.997337341308594,0.5905511811023622,0,127,52,75,0,52,0,75
11,2,9.992536544799805,0.5905511811023622,0,127,52,75,0,52,0,75
11,3,1.459851861000061,0.4015748031496063,120,7,52,75,48,4,72,3
11,4,1.4112012386322021,0.4094488188976378,127,0,52,75,52,0,75,0
11,5,1.6338765621185303,0.4094488188976378,127,0,52,75,52,0,75,0
11,6,1.3013607263565063,0.4094488188976378,127,0,52,75,52,0,75,0
11,7,0.8935562968254089,0.4094488188976378,125,2,52,75,51,1,74,1
11,8,0.7707476615905762,0.4881889763779528,109,18,52,75,48,4,61,14
11,9,0.741007924079895,0.5275590551181102,94,33,52,75,43,9,51,24
11,10,0.7798134684562683,0.5196850393700787,83,44,52,75,37,15,46,29
11,11,0.7365179657936096,0.5511811023622047,75,52,52,75,35,17,40,35
11,12,0.687023401260376,0.5748031496062992,76,51,52,75,37,15,39,36
11,13,0.6353899240493774,0.6062992125984252,78,49,52,75,40,12,38,37
11,14,0.6154726147651672,0.5905511811023622,86,41,52,75,43,9,43,32
11,15,0.5618007779121399,0.5275590551181102,98,29,52,75,45,7,53,22
11,16,0.530629575252533,0.5039370078740157,105,22,52,75,47,5,58,17
11,17,0.5176553726196289,0.4881889763779528,109,18,52,75,48,4,61,14
11,18,0.49589017033576965,0.4645669291338583,112,15,52,75,48,4,64,11
11,19,0.504148006439209,0.4566929133858268,115,12,52,75,49,3,66,9
11,20,0.48293283581733704,0.4566929133858268,115,12,52,75,49,3,66,9
11,21,0.47270748019218445,0.4645669291338583,116,11,52,75,50,2,66,9
11,22,0.47107601165771484,0.47244094488188976,115,12,52,75,50,2,65,10
11,23,0.4641852080821991,0.4881889763779528,113,14,52,75,50,2,63,12
11,24,0.4302704334259033,0.5118110236220472,110,17,52,75,50,2,60,15
11,25,0.4263048470020294,0.5354330708661418,107,20,52,75,50,2,57,18
11,26,0.44795167446136475,0.5590551181102362,104,23,52,75,50,2,54,21
11,27,0.41136667132377625,0.5826771653543307,101,26,52,75,50,2,51,24
11,28,0.3843100070953369,0.5905511811023622,98,29,52,75,49,3,49,26
11,29,0.355965256690979,0.5984251968503937,97,30,52,75,49,3,48,27
11,30,0.35023874044418335,0.6456692913385826,91,36,52,75,49,3,42,33
11,31,0.3557858467102051,0.6692913385826772,86,41,52,75,48,4,38,37
11,32,0.3260399103164673,0.7086614173228346,81,46,52,75,48,4,33,42
11,33,0.3182188868522644,0.7165354330708661,80,47,52,75,48,4,32,43
11,34,0.3298034369945526,0.7244094488188977,79,48,52,75,48,4,31,44
11,35,0.31303319334983826,0.7244094488188977,79,48,52,75,48,4,31,44
11,36,0.31285205483436584,0.7244094488188977,77,50,52,75,47,5,30,45
11,37,0.2927514612674713,0.7322834645669292,76,51,52,75,47,5,29,46
11,38,0.28376835584640503,0.7480314960629921,74,53,52,75,47,5,27,48
11,39,0.27433258295059204,0.7480314960629921,74,53,52,75,47,5,27,48
11,40,0.26338768005371094,0.7480314960629921,74,53,52,75,47,5,27,48
11,41,0.2515077292919159,0.7480314960629921,74,53,52,75,47,5,27,48
11,42,0.2528230845928192,0.7480314960629921,74,53,52,75,47,5,27,48
11,43,0.2367028445005417,0.7480314960629921,74,53,52,75,47,5,27,48
11,44,0.22569243609905243,0.7480314960629921,74,53,52,75,47,5,27,48
11,45,0.23197035491466522,0.7559055118110236,73,54,52,75,47,5,26,49
11,46,0.2381214201450348,0.7480314960629921,74,53,52,75,47,5,27,48
11,47,0.22882495820522308,0.7401574803149606,75,52,52,75,47,5,28,47
11,48,0.21535903215408325,0.7401574803149606,75,52,52,75,47,5,28,47
11,49,0.208997905254364,0.7401574803149606,75,52,52,75,47,5,28,47
12,0,0.7289183735847473,0.4094488188976378,127,0,52,75,52,0,75,0
12,1,42.028465270996094,0.4094488188976378,127,0,52,75,52,0,75,0
12,2,6.8866167068481445,0.5905511811023622,0,127,52,75,0,52,0,75
12,3,1.2121765613555908,0.5826771653543307,1,126,52,75,0,52,1,74
12,4,1.642418622970581,0.5905511811023622,0,127,52,75,0,52,0,75
12,5,1.2350428104400635,0.5984251968503937,1,126,52,75,1,51,0,75
12,6,0.8439460396766663,0.6614173228346457,9,118,52,75,9,43,0,75
12,7,0.7479916214942932,0.7165354330708661,24,103,52,75,20,32,4,71
12,8,0.6518023610115051,0.6929133858267716,41,86,52,75,27,25,14,61
12,9,0.5848156809806824,0.6850393700787402,48,79,52,75,30,22,18,57
12,10,0.5884301662445068,0.7086614173228346,49,78,52,75,32,20,17,58
12,11,0.6118277311325073,0.7480314960629921,36,91,52,75,28,24,8,67
12,12,0.5250858664512634,0.7322834645669292,22,105,52,75,20,32,2,73
12,13,0.5107777118682861,0.7244094488188977,21,106,52,75,19,33,2,73
12,14,0.47031912207603455,0.7086614173228346,19,108,52,75,17,35,2,73
12,15,0.4728092551231384,0.7007874015748031,16,111,52,75,15,37,1,74
12,16,0.4161246120929718,0.7007874015748031,16,111,52,75,15,37,1,74
12,17,0.43601396679878235,0.7086614173228346,19,108,52,75,17,35,2,73
12,18,0.3809977173805237,0.7244094488188977,29,98,52,75,23,29,6,69
12,19,0.367015540599823,0.7637795275590551,34,93,52,75,28,24,6,69
12,20,0.3518718481063843,0.7401574803149606,27,100,52,75,23,29,4,71
12,21,0.2921546995639801,0.7401574803149606,27,100,52,75,23,29,4,71
12,22,0.2993144094944,0.7322834645669292,28,99,52,75,23,29,5,70
12,23,0.3091438412666321,0.7795275590551181,36,91,52,75,30,22,6,69
12,24,0.2610158920288086,0.8346456692913385,47,80,52,75,39,13,8,67
12,25,0.25850680470466614,0.8267716535433071,54,73,52,75,42,10,12,63
12,26,0.2682829201221466,0.8346456692913385,49,78,52,75,40,12,9,66
12,27,0.20494447648525238,0.8110236220472441,44,83,52,75,36,16,8,67
12,28,0.20654988288879395,0.7795275590551181,40,87,52,75,32,20,8,67
12,29,0.22431012988090515,0.8267716535433071,48,79,52,75,39,13,9,66
12,30,0.19167496263980865,0.8188976377952756,51,76,52,75,40,12,11,64
12,31,0.19828647375106812,0.8110236220472441,48,79,52,75,38,14,10,65
12,32,0.2028808295726776,0.7952755905511811,40,87,52,75,33,19,7,68
12,33,0.15524742007255554,0.7952755905511811,34,93,52,75,30,22,4,71
12,34,0.15403807163238525,0.7874015748031497,33,94,52,75,29,23,4,71
12,35,0.15364137291908264,0.7874015748031497,33,94,52,75,29,23,4,71
12,36,0.1255822777748108,0.7716535433070866,35,92,52,75,29,23,6,69
12,37,0.1272558718919754,0.7716535433070866,39,88,52,75,31,21,8,67
12,38,0.15438883006572723,0.7874015748031497,37,90,52,75,31,21,6,69
12,39,0.11270661652088165,0.7637795275590551,40,87,52,75,31,21,9,66
12,40,0.10897481441497803,0.7637795275590551,42,85,52,75,32,20,10,65
12,41,0.11827454715967178,0.7716535433070866,43,84,52,75,33,19,10,65
12,42,0.11309651285409927,0.7795275590551181,44,83,52,75,34,18,10,65
12,43,0.11523060500621796,0.7952755905511811,48,79,52,75,37,15,11,64
12,44,0.08235377073287964,0.8110236220472441,50,77,52,75,39,13,11,64
12,45,0.10471758991479874,0.8110236220472441,50,77,52,75,39,13,11,64
12,46,0.08595510572195053,0.7874015748031497,51,76,52,75,38,14,13,62
12,47,0.09141521155834198,0.7952755905511811,50,77,52,75,38,14,12,63
12,48,0.09400070458650589,0.7874015748031497,49,78,52,75,37,15,12,63
12,49,0.06976994127035141,0.7716535433070866,47,80,52,75,35,17,12,63
13,0,0.7560299634933472,0.4094488188976378,127,0,52,75,52,0,75,0
13,1,42.4985466003418,0.4094488188976378,127,0,52,75,52,0,75,0
13,2,9.705851554870605,0.5905511811023622,0,127,52,75,0,52,0,75
13,3,1.3469270467758179,0.48031496062992124,24,103,52,75,5,47,19,56
13,4,2.0113725662231445,0.5905511811023622,10,117,52,75,5,47,5,70
13,5,1.3059858083724976,0.5984251968503937,31,96,52,75,16,36,15,60
13,6,0.7739923596382141,0.5748031496062992,58,69,52,75,28,24,30,45
13,7,1.30255126953125,0.5354330708661418,71,56,52,75,32,20,39,36
13,8,0.971958339214325,0.5275590551181102,68,59,52,75,30,22,38,37
13,9,0.6377325654029846,0.5196850393700787,55,72,52,75,23,29,32,43
13,10,0.670407235622406,0.5590551181102362,40,87,52,75,18,34,22,53
13,11,0.6229636073112488,0.5748031496062992,36,91,52,75,17,35,19,56
13,12,0.5610635876655579,0.5826771653543307,27,100,52,75,13,39,14,61
13,13,0.5324447751045227,0.6299212598425197,21,106,52,75,13,39,8,67
13,14,0.4793645441532135,0.6535433070866141,18,109,52,75,13,39,5,70
13,15,0.4682559072971344,0.7007874015748031,22,105,52,75,18,34,4,71
13,16,0.42299163341522217,0.7322834645669292,26,101,52,75,22,30,4,71
13,17,0.39671754837036133,0.7480314960629921,36,91,52,75,28,24,8,67
13,18,0.37287402153015137,0.7165354330708661,44,83,52,75,30,22,14,61
13,19,0.36794713139533997,0.7322834645669292,52,75,52,75,35,17,17,58
13,20,0.3432597815990448,0.7244094488188977,57,70,52,75,37,15,20,55
13,21,0.3155716061592102,0.7244094488188977,55,72,52,75,36,16,19,56
13,22,0.2983536720275879,0.7322834645669292,64,63,52,75,41,11,23,52
13,23,0.27063503861427307,0.7322834645669292,60,67,52,75,39,13,21,54
13,24,0.24807573854923248,0.7480314960629921,54,73,52,75,37,15,17,58
13,25,0.28842589259147644,0.7322834645669292,58,69,52,75,38,14,20,55
13,26,0.23080900311470032,0.7322834645669292,60,67,52,75,39,13,21,54
13,27,0.2690943479537964,0.7559055118110236,53,74,52,75,37,15,16,59
13,28,0.2176722288131714,0.7716535433070866,49,78,52,75,36,16,13,62
13,29,0.24768584966659546,0.7401574803149606,55,72,52,75,37,15,18,57
13,30,0.191545769572258,0.7401574803149606,55,72,52,75,37,15,18,57
13,31,0.21329259872436523,0.7716535433070866,51,76,52,75,37,15,14,61
13,32,0.18357345461845398,0.7795275590551181,48,79,52,75,36,16,12,63
13,33,0.1776716709136963,0.7874015748031497,43,84,52,75,34,18,9,66
13,34,0.1596193015575409,0.7952755905511811,42,85,52,75,34,18,8,67
13,35,0.1433861404657364,0.7874015748031497,41,86,52,75,33,19,8,67
13,36,0.15867766737937927,0.7952755905511811,42,85,52,75,34,18,8,67
13,37,0.15444748103618622,0.7952755905511811,42,85,52,75,34,18,8,67
13,38,0.1413850337266922,0.7952755905511811,42,85,52,75,34,18,8,67
13,39,0.13123370707035065,0.7795275590551181,40,87,52,75,32,20,8,67
13,40,0.12449117749929428,0.7795275590551181,40,87,52,75,32,20,8,67
13,41,0.128792405128479,0.7874015748031497,39,88,52,75,32,20,7,68
13,42,0.12321142852306366,0.7795275590551181,38,89,52,75,31,21,7,68
13,43,0.10883872210979462,0.7795275590551181,38,89,52,75,31,21,7,68
13,44,0.11698511242866516,0.7874015748031497,39,88,52,75,32,20,7,68
13,45,0.11708413064479828,0.7716535433070866,39,88,52,75,31,21,8,67
13,46,0.10548224300146103,0.7637795275590551,38,89,52,75,30,22,8,67
13,47,0.09761930257081985,0.7637795275590551,36,91,52,75,29,23,7,68
13,48,0.09195557981729507,0.7480314960629921,36,91,52,75,28,24,8,67
13,49,0.0891394391655922,0.7559055118110236,37,90,52,75,29,23,8,67
14,0,0.8717254996299744,0.5826771653543307,0,127,53,74,0,53,0,74
14,1,40.11244583129883,0.5826771653543307,0,127,53,74,0,53,0,74
14,2,9.150071144104004,0.5669291338582677,4,123,53,74,1,52,3,71
14,3,1.8136388063430786,0.4645669291338583,49,78,53,74,17,36,32,42
14,4,1.580436110496521,0.41732283464566927,127,0,53,74,53,0,74,0
14,5,1.793060302734375,0.41732283464566927,127,0,53,74,53,0,74,0
14,6,1.4708304405212402,0.41732283464566927,125,2,53,74,52,1,73,1
14,7,0.9721345901489258,0.4330708661417323,113,14,53,74,47,6,66,8
14,8,0.7706319093704224,0.48031496062992124,93,34,53,74,40,13,53,21
14,9,0.7593443393707275,0.5590551181102362,69,58,53,74,33,20,36,38
14,10,0.7821134924888611,0.5748031496062992,57,70,53,74,28,25,29,45
14,11,0.7620083689689636,0.5984251968503937,56,71,53,74,29,24,27,47
14,12,0.7162132859230042,0.5984251968503937,58,69,53,74,30,23,28,46
14,13,0.6571338176727295,0.6062992125984252,71,56,53,74,37,16,34,40
14,14,0.6034818887710571,0.6377952755905512,77,50,53,74,42,11,35,39
14,15,0.5440185070037842,0.6062992125984252,91,36,53,74,47,6,44,30
14,16,0.5015565752983093,0.5905511811023622,99,28,53,74,50,3,49,25
14,17,0.4729604423046112,0.5669291338582677,104,23,53,74,51,2,53,21
14,18,0.4897119402885437,0.5669291338582677,104,23,53,74,51,2,53,21
14,19,0.47826552391052246,0.5669291338582677,104,23,53,74,51,2,53,21
14,20,0.4765385389328003,0.5905511811023622,101,26,53,74,51,2,50,24
14,21,0.4429861605167389,0.6062992125984252,99,28,53,74,51,2,48,26
14,22,0.4259071946144104,0.6299212598425197,96,31,53,74,51,2,45,29
14,23,0.3992939889431,0.6456692913385826,94,33,53,74,51,2,43,31
14,24,0.3900923430919647,0.6771653543307087,90,37,53,74,51,2,39,35
14,25,0.3848337233066559,0.6929133858267716,86,41,53,74,50,3,36,38
14,26,0.3705310523509979,0.6929133858267716,86,41,53,74,50,3,36,38
14,27,0.3640402853488922,0.7165354330708661,83,44,53,74,50,3,33,41
14,28,0.33853092789649963,0.7322834645669292,79,48,53,74,49,4,30,44
14,29,0.33896270394325256,0.7480314960629921,77,50,53,74,49,4,28,46
14,30,0.31818512082099915,0.7716535433070866,76,51,53,74,50,3,26,48
14,31,0.3240889310836792,0.7874015748031497,72,55,53,74,49,4,23,51
14,32,0.2728961408138275,0.7874015748031497,70,57,53,74,48,5,22,52
14,33,0.2910691201686859,0.7874015748031497,70,57,53,74,48,5,22,52
14,34,0.27942097187042236,0.8031496062992126,68,59,53,74,48,5,20,54
14,35,0.2698967158794403,0.7952755905511811,65,62,53,74,46,7,19,55
14,36,0.2709712088108063,0.7874015748031497,64,63,53,74,45,8,19,55
14,37,0.2505090534687042,0.7952755905511811,63,64,53,74,45,8,18,56
14,38,0.2535369396209717,0.7952755905511811,63,64,53,74,45,8,18,56
14,39,0.23162175714969635,0.8031496062992126,64,63,53,74,46,7,18,56
14,40,0.2240191400051117,0.7952755905511811,65,62,53,74,46,7,19,55
14,41,0.22563277184963226,0.7874015748031497,66,61,53,74,46,7,20,54
14,42,0.21046952903270721,0.7874015748031497,66,61,53,74,46,7,20,54
14,43,0.1931837946176529,0.7795275590551181,65,62,53,74,45,8,20,54
14,44,0.2040579617023468,0.7952755905511811,63,64,53,74,45,8,18,56
14,45,0.1964121162891388,0.7952755905511811,63,64,53,74,45,8,18,56
14,46,0.17509083449840546,0.8188976377952756,60,67,53,74,45,8,15,59
14,47,0.1919686198234558,0.8031496062992126,62,65,53,74,45,8,17,57
14,48,0.17016036808490753,0.8031496062992126,62,65,53,74,45,8,17,57
14,49,0.18241733312606812,0.8031496062992126,66,61,53,74,47,6,19,55
15,0,0.8631004691123962,0.5826771653543307,0,127,53,74,0,53,0,74
15,1,39.79384994506836,0.5826771653543307,0,127,53,74,0,53,0,74
15,2,9.267909049987793,0.5826771653543307,0,127,53,74,0,53,0,74
15,3,1.2364413738250732,0.41732283464566927,127,0,53,74,53,0,74,0
15,4,1.4016728401184082,0.41732283464566927,127,0,53,74,53,0,74,0
15,5,1.549565076828003,0.4251968503937008,126,1,53,74,53,0,73,1
15,6,1.248748779296875,0.4330708661417323,125,2,53,74,53,0,72,2
15,7,0.8882949352264404,0.47244094488188976,116,11,53,74,51,2,65,9
15,8,0.7655168771743774,0.5354330708661418,96,31,53,74,45,8,51,23
15,9,0.7294282913208008,0.5511811023622047,76,51,53,74,36,17,40,34
15,10,0.7299318909645081,0.5590551181102362,63,64,53,74,30,23,33,41
15,11,0.7107390761375427,0.5905511811023622,65,62,53,74,33,20,32,42
15,12,0.6454108357429504,0.5984251968503937,74,53,53,74,38,15,36,38
15,13,0.6397138237953186,0.5826771653543307,86,41,53,74,43,10,43,31
15,14,0.6168588399887085,0.5511811023622047,94,33,53,74,45,8,49,25
15,15,0.562751054763794,0.5354330708661418,100,27,53,74,47,6,53,21
15,16,0.5356247425079346,0.5196850393700787,102,25,53,74,47,6,55,19
15,17,0.5299386978149414,0.49606299212598426,107,20,53,74,48,5,59,15
15,18,0.5229618549346924,0.47244094488188976,110,17,53,74,48,5,62,12
15,19,0.5183586478233337,0.47244094488188976,110,17,53,74,48,5,62,12
15,20,0.4922989308834076,0.48031496062992124,111,16,53,74,49,4,62,12
15,21,0.49264082312583923,0.4881889763779528,114,13,53,74,51,2,63,11
15,22,0.480551153421402,0.4881889763779528,114,13,53,74,51,2,63,11
15,23,0.4561957120895386,0.4881889763779528,114,13,53,74,51,2,63,11
15,24,0.45946958661079407,0.5196850393700787,110,17,53,74,51,2,59,15
15,25,0.4438750147819519,0.5433070866141733,105,22,53,74,50,3,55,19
15,26,0.4322957694530487,0.5433070866141733,105,22,53,74,50,3,55,19
15,27,0.4279680848121643,0.5511811023622047,102,25,53,74,49,4,53,21
15,28,0.41875168681144714,0.5669291338582677,98,29,53,74,48,5,50,24
15,29,0.3951355218887329,0.5826771653543307,96,31,53,74,48,5,48,26
15,30,0.3876135051250458,0.5984251968503937,94,33,53,74,48,5,46,28
15,31,0.37292778491973877,0.6377952755905512,89,38,53,74,48,5,41,33
15,32,0.3613511025905609,0.6377952755905512,89,38,53,74,48,5,41,33
15,33,0.3532159626483917,0.6771653543307087,84,43,53,74,48,5,36,38
15,34,0.32932862639427185,0.6929133858267716,82,45,53,74,48,5,34,40
15,35,0.32485899329185486,0.7007874015748031,81,46,53,74,48,5,33,41
15,36,0.31947171688079834,0.7086614173228346,80,47,53,74,48,5,32,42
15,37,0.30727067589759827,0.7086614173228346,80,47,53,74,48,5,32,42
15,38,0.30143076181411743,0.7086614173228346,80,47,53,74,48,5,32,42
15,39,0.30968931317329407,0.7165354330708661,79,48,53,74,48,5,31,43
15,40,0.2717224657535553,0.7244094488188977,76,51,53,74,47,6,29,45
15,41,0.276345819234848,0.7322834645669292,77,50,53,74,48,5,29,45
15,42,0.2653222978115082,0.7322834645669292,77,50,53,74,48,5,29,45
15,43,0.2720062732696533,0.7165354330708661,79,48,53,74,48,5,31,43
15,44,0.27696922421455383,0.7322834645669292,77,50,53,74,48,5,29,45
15,45,0.2514025568962097,0.7480314960629921,75,52,53,74,48,5,27,47
15,46,0.2558628022670746,0.7480314960629921,75,52,53,74,48,5,27,47
15,47,0.2305442839860916,0.7322834645669292,75,52,53,74,47,6,28,46
15,48,0.23348486423492432,0.7401574803149606,72,55,53,74,46,7,26,48
15,49,0.2307986319065094,0.7480314960629921,71,56,53,74,46,7,25,49
