Fold,Epoch,Loss,Accuracy,Pred_Real,Pred_Fake,True_Real,True_Fake,TN,FP,FN,TP
1,0,0.6965866684913635,0.4140625,128,0,53,75,53,0,75,0
1,1,0.561967134475708,0.4140625,128,0,53,75,53,0,75,0
1,2,0.45993149280548096,0.4140625,128,0,53,75,53,0,75,0
1,3,0.3427891731262207,0.6875,87,41,53,75,50,3,37,38
1,4,0.28459402918815613,0.703125,51,77,53,75,33,20,18,57
1,5,0.23319169878959656,0.703125,51,77,53,75,33,20,18,57
1,6,0.1877211034297943,0.7265625,52,76,53,75,35,18,17,58
1,7,0.16062398254871368,0.7421875,48,80,53,75,34,19,14,61
1,8,0.13563646376132965,0.734375,41,87,53,75,30,23,11,64
1,9,0.11185585707426071,0.734375,39,89,53,75,29,24,10,65
1,10,0.0961214229464531,0.7421875,42,86,53,75,31,22,11,64
1,11,0.08161436766386032,0.734375,51,77,53,75,35,18,16,59
1,12,0.06884285062551498,0.7265625,58,70,53,75,38,15,20,55
1,13,0.06012656167149544,0.703125,65,63,53,75,40,13,25,50
1,14,0.0519820861518383,0.6953125,70,58,53,75,42,11,28,47
1,15,0.04396689310669899,0.6875,71,57,53,75,42,11,29,46
1,16,0.038837458938360214,0.6953125,70,58,53,75,42,11,28,47
1,17,0.03420193865895271,0.6953125,70,58,53,75,42,11,28,47
1,18,0.029545119032263756,0.6875,67,61,53,75,40,13,27,48
1,19,0.025445586070418358,0.6875,65,63,53,75,39,14,26,49
1,20,0.02277587354183197,0.6875,63,65,53,75,38,15,25,50
1,21,0.02178841456770897,0.703125,59,69,53,75,37,16,22,53
1,22,0.018972208723425865,0.7109375,56,72,53,75,36,17,20,55
1,23,0.017569750547409058,0.71875,55,73,53,75,36,17,19,56
1,24,0.015740731731057167,0.7265625,52,76,53,75,35,18,17,58
1,25,0.014211690984666348,0.7265625,52,76,53,75,35,18,17,58
1,26,0.014060180634260178,0.7109375,50,78,53,75,33,20,17,58
1,27,0.01192440278828144,0.703125,49,79,53,75,32,21,17,58
1,28,0.010689038783311844,0.71875,47,81,53,75,32,21,15,60
1,29,0.010186765342950821,0.734375,45,83,53,75,32,21,13,62
1,30,0.009680268354713917,0.734375,45,83,53,75,32,21,13,62
1,31,0.00888363178819418,0.734375,45,83,53,75,32,21,13,62
1,32,0.008676163852214813,0.734375,45,83,53,75,32,21,13,62
1,33,0.008346554823219776,0.734375,45,83,53,75,32,21,13,62
1,34,0.007616672199219465,0.7421875,44,84,53,75,32,21,12,63
1,35,0.006890653632581234,0.7421875,44,84,53,75,32,21,12,63
1,36,0.0072287218645215034,0.7421875,44,84,53,75,32,21,12,63
1,37,0.006607568357139826,0.7421875,44,84,53,75,32,21,12,63
1,38,0.007203653920441866,0.7265625,46,82,53,75,32,21,14,61
1,39,0.006699431221932173,0.7265625,46,82,53,75,32,21,14,61
1,40,0.007084980607032776,0.7265625,48,80,53,75,33,20,15,60
1,41,0.006213097367435694,0.7265625,48,80,53,75,33,20,15,60
1,42,0.007396195083856583,0.7265625,48,80,53,75,33,20,15,60
1,43,0.005672380793839693,0.734375,49,79,53,75,34,19,15,60
1,44,0.005684068892151117,0.734375,49,79,53,75,34,19,15,60
1,45,0.005961148533970118,0.734375,49,79,53,75,34,19,15,60
1,46,0.005306317936629057,0.734375,49,79,53,75,34,19,15,60
1,47,0.006037467624992132,0.7421875,50,78,53,75,35,18,15,60
1,48,0.005667382851243019,0.75,51,77,53,75,36,17,15,60
1,49,0.005447418428957462,0.75,53,75,53,75,37,16,16,59
2,0,0.7217205166816711,0.4094488188976378,127,0,52,75,52,0,75,0
2,1,0.6759732961654663,0.6141732283464567,5,122,52,75,4,48,1,74
2,2,0.4769219756126404,0.5905511811023622,0,127,52,75,0,52,0,75
2,3,0.40704354643821716,0.5905511811023622,0,127,52,75,0,52,0,75
2,4,0.3359743058681488,0.8031496062992126,37,90,52,75,32,20,5,70
2,5,0.27792423963546753,0.7007874015748031,88,39,52,75,51,1,37,38
2,6,0.23950742185115814,0.5511811023622047,107,20,52,75,51,1,56,19
2,7,0.20631922781467438,0.5039370078740157,115,12,52,75,52,0,63,12
2,8,0.1777266263961792,0.4645669291338583,120,7,52,75,52,0,68,7
2,9,0.1529131531715393,0.44881889763779526,122,5,52,75,52,0,70,5
2,10,0.13383899629116058,0.4330708661417323,124,3,52,75,52,0,72,3
2,11,0.11688979715108871,0.4330708661417323,124,3,52,75,52,0,72,3
2,12,0.10333043336868286,0.4251968503937008,125,2,52,75,52,0,73,2
2,13,0.0886484757065773,0.4251968503937008,125,2,52,75,52,0,73,2
2,14,0.07613338530063629,0.4330708661417323,124,3,52,75,52,0,72,3
2,15,0.0688944011926651,0.4330708661417323,124,3,52,75,52,0,72,3
2,16,0.0597754567861557,0.4330708661417323,122,5,52,75,51,1,71,4
2,17,0.05159490928053856,0.44881889763779526,120,7,52,75,51,1,69,6
2,18,0.046279653906822205,0.47244094488188976,117,10,52,75,51,1,66,9
2,19,0.040279027074575424,0.4645669291338583,116,11,52,75,50,2,66,9
2,20,0.03555448353290558,0.48031496062992124,114,13,52,75,50,2,64,11
2,21,0.032559167593717575,0.4881889763779528,113,14,52,75,50,2,63,12
2,22,0.02911858633160591,0.5039370078740157,111,16,52,75,50,2,61,14
2,23,0.02543392777442932,0.5118110236220472,110,17,52,75,50,2,60,15
2,24,0.023503292351961136,0.5433070866141733,102,25,52,75,48,4,54,21
2,25,0.020919300615787506,0.5590551181102362,100,27,52,75,48,4,52,23
2,26,0.01884726993739605,0.5748031496062992,98,29,52,75,48,4,50,25
2,27,0.016835467889904976,0.5905511811023622,96,31,52,75,48,4,48,27
2,28,0.014933113940060139,0.6062992125984252,94,33,52,75,48,4,46,29
2,29,0.01559764239937067,0.6299212598425197,89,38,52,75,47,5,42,33
2,30,0.014772198162972927,0.6535433070866141,86,41,52,75,47,5,39,36
2,31,0.01332902442663908,0.6456692913385826,83,44,52,75,45,7,38,37
2,32,0.011740472167730331,0.6377952755905512,82,45,52,75,44,8,38,37
2,33,0.012063696049153805,0.6692913385826772,78,49,52,75,44,8,34,41
2,34,0.011303650215268135,0.7086614173228346,73,54,52,75,44,8,29,46
2,35,0.009905189275741577,0.7165354330708661,72,55,52,75,44,8,28,47
2,36,0.009252755902707577,0.7244094488188977,71,56,52,75,44,8,27,48
2,37,0.008518197573721409,0.7322834645669292,70,57,52,75,44,8,26,49
2,38,0.00837750919163227,0.7559055118110236,67,60,52,75,44,8,23,52
2,39,0.007447974756360054,0.7559055118110236,67,60,52,75,44,8,23,52
2,40,0.0071993242017924786,0.7795275590551181,64,63,52,75,44,8,20,55
2,41,0.0071996343322098255,0.7952755905511811,60,67,52,75,43,9,17,58
2,42,0.007259680423885584,0.7874015748031497,59,68,52,75,42,10,17,58
2,43,0.006231615785509348,0.7795275590551181,58,69,52,75,41,11,17,58
2,44,0.0070481370203197,0.7874015748031497,57,70,52,75,41,11,16,59
2,45,0.00687206257134676,0.7874015748031497,55,72,52,75,40,12,15,60
2,46,0.006436563096940517,0.7952755905511811,54,73,52,75,40,12,14,61
2,47,0.005984714720398188,0.7952755905511811,54,73,52,75,40,12,14,61
2,48,0.0054531218484044075,0.7952755905511811,54,73,52,75,40,12,14,61
2,49,0.0055540380999445915,0.7952755905511811,54,73,52,75,40,12,14,61
3,0,0.7007957696914673,0.5984251968503937,1,126,52,75,1,51,0,75
3,1,0.6685490012168884,0.5905511811023622,0,127,52,75,0,52,0,75
3,2,0.4547446668148041,0.5905511811023622,0,127,52,75,0,52,0,75
3,3,0.402283638715744,0.5905511811023622,0,127,52,75,0,52,0,75
3,4,0.3219194710254669,0.5905511811023622,0,127,52,75,0,52,0,75
3,5,0.2608402967453003,0.5905511811023622,0,127,52,75,0,52,0,75
3,6,0.22639551758766174,0.5905511811023622,0,127,52,75,0,52,0,75
3,7,0.19013415277004242,0.5905511811023622,0,127,52,75,0,52,0,75
3,8,0.16005927324295044,0.5984251968503937,1,126,52,75,1,51,0,75
3,9,0.13595569133758545,0.5984251968503937,1,126,52,75,1,51,0,75
3,10,0.11756733059883118,0.6456692913385826,7,120,52,75,7,45,0,75
3,11,0.10108377039432526,0.7165354330708661,16,111,52,75,16,36,0,75
3,12,0.0862259492278099,0.7322834645669292,18,109,52,75,18,34,0,75
3,13,0.07267926633358002,0.7874015748031497,29,98,52,75,27,25,2,73
3,14,0.06256050616502762,0.7795275590551181,30,97,52,75,27,25,3,72
3,15,0.055771034210920334,0.8110236220472441,36,91,52,75,32,20,4,71
3,16,0.04838431626558304,0.84251968503937,42,85,52,75,37,15,5,70
3,17,0.04122988134622574,0.8661417322834646,45,82,52,75,40,12,5,70
3,18,0.03614453226327896,0.8818897637795275,49,78,52,75,43,9,6,69
3,19,0.031831543892621994,0.8740157480314961,50,77,52,75,43,9,7,68
3,20,0.028652820736169815,0.889763779527559,52,75,52,75,45,7,7,68
3,21,0.025709321722388268,0.889763779527559,52,75,52,75,45,7,7,68
3,22,0.022698746994137764,0.8818897637795275,53,74,52,75,45,7,8,67
3,23,0.019492257386446,0.8818897637795275,53,74,52,75,45,7,8,67
3,24,0.017686687409877777,0.889763779527559,54,73,52,75,46,6,8,67
3,25,0.016443388536572456,0.889763779527559,56,71,52,75,47,5,9,66
3,26,0.014393002726137638,0.889763779527559,56,71,52,75,47,5,9,66
3,27,0.013539884239435196,0.8818897637795275,57,70,52,75,47,5,10,65
3,28,0.011806655675172806,0.8818897637795275,57,70,52,75,47,5,10,65
3,29,0.011737767606973648,0.8818897637795275,57,70,52,75,47,5,10,65
3,30,0.010351871140301228,0.889763779527559,56,71,52,75,47,5,9,66
3,31,0.009946531616151333,0.889763779527559,56,71,52,75,47,5,9,66
3,32,0.009164989925920963,0.889763779527559,56,71,52,75,47,5,9,66
3,33,0.008625498972833157,0.889763779527559,56,71,52,75,47,5,9,66
3,34,0.008593789301812649,0.889763779527559,56,71,52,75,47,5,9,66
3,35,0.007706775795668364,0.8818897637795275,55,72,52,75,46,6,9,66
3,36,0.007450175005942583,0.8740157480314961,54,73,52,75,45,7,9,66
3,37,0.007006803993135691,0.8740157480314961,54,73,52,75,45,7,9,66
3,38,0.006357870064675808,0.8740157480314961,54,73,52,75,45,7,9,66
3,39,0.007108111400157213,0.8818897637795275,53,74,52,75,45,7,8,67
3,40,0.006896932143718004,0.8818897637795275,53,74,52,75,45,7,8,67
3,41,0.005870066583156586,0.8818897637795275,53,74,52,75,45,7,8,67
3,42,0.006470150779932737,0.8818897637795275,53,74,52,75,45,7,8,67
3,43,0.005558626260608435,0.889763779527559,52,75,52,75,45,7,7,68
3,44,0.005434696096926928,0.889763779527559,52,75,52,75,45,7,7,68
3,45,0.0054778908379375935,0.889763779527559,52,75,52,75,45,7,7,68
3,46,0.005051687825471163,0.889763779527559,52,75,52,75,45,7,7,68
3,47,0.004960877820849419,0.889763779527559,52,75,52,75,45,7,7,68
3,48,0.004958584439009428,0.889763779527559,52,75,52,75,45,7,7,68
3,49,0.005997737869620323,0.8818897637795275,51,76,52,75,44,8,7,68
4,0,0.7005933523178101,0.4094488188976378,127,0,52,75,52,0,75,0
4,1,0.6889338493347168,0.4094488188976378,127,0,52,75,52,0,75,0
4,2,0.456930547952652,0.4094488188976378,127,0,52,75,52,0,75,0
4,3,0.40511375665664673,0.4094488188976378,127,0,52,75,52,0,75,0
4,4,0.3396085500717163,0.4094488188976378,127,0,52,75,52,0,75,0
4,5,0.27363520860671997,0.4094488188976378,127,0,52,75,52,0,75,0
4,6,0.23485958576202393,0.48031496062992124,118,9,52,75,52,0,66,9
4,7,0.20761743187904358,0.5748031496062992,102,25,52,75,50,2,52,23
4,8,0.1791720688343048,0.6456692913385826,93,34,52,75,50,2,43,32
4,9,0.1511368751525879,0.7165354330708661,84,43,52,75,50,2,34,41
4,10,0.1323385387659073,0.7795275590551181,72,55,52,75,48,4,24,51
4,11,0.117963507771492,0.8110236220472441,62,65,52,75,45,7,17,58
4,12,0.10299257189035416,0.8110236220472441,48,79,52,75,38,14,10,65
4,13,0.08813173323869705,0.8031496062992126,37,90,52,75,32,20,5,70
4,14,0.07894014567136765,0.7716535433070866,33,94,52,75,28,24,5,70
4,15,0.06849796324968338,0.7480314960629921,28,99,52,75,24,28,4,71
4,16,0.06099443510174751,0.7401574803149606,27,100,52,75,23,29,4,71
4,17,0.05395076051354408,0.7401574803149606,27,100,52,75,23,29,4,71
4,18,0.046885568648576736,0.7401574803149606,29,98,52,75,24,28,5,70
4,19,0.042036958038806915,0.7401574803149606,29,98,52,75,24,28,5,70
4,20,0.03816589340567589,0.7637795275590551,32,95,52,75,27,25,5,70
4,21,0.0336185023188591,0.7637795275590551,34,93,52,75,28,24,6,69
4,22,0.03013603575527668,0.7716535433070866,35,92,52,75,29,23,6,69
4,23,0.027776682749390602,0.7716535433070866,35,92,52,75,29,23,6,69
4,24,0.02601783163845539,0.7637795275590551,36,91,52,75,29,23,7,68
4,25,0.02330585941672325,0.7637795275590551,36,91,52,75,29,23,7,68
4,26,0.021657319739460945,0.7716535433070866,37,90,52,75,30,22,7,68
4,27,0.020201819017529488,0.7559055118110236,39,88,52,75,30,22,9,66
4,28,0.017755866050720215,0.7637795275590551,40,87,52,75,31,21,9,66
4,29,0.017287900671362877,0.7716535433070866,41,86,52,75,32,20,9,66
4,30,0.014958309009671211,0.7716535433070866,41,86,52,75,32,20,9,66
4,31,0.01379607804119587,0.7716535433070866,41,86,52,75,32,20,9,66
4,32,0.014293337240815163,0.7716535433070866,41,86,52,75,32,20,9,66
4,33,0.016045700758695602,0.7716535433070866,41,86,52,75,32,20,9,66
4,34,0.01263450924307108,0.7716535433070866,43,84,52,75,33,19,10,65
4,35,0.012558170594274998,0.7795275590551181,44,83,52,75,34,18,10,65
4,36,0.010938448831439018,0.7795275590551181,44,83,52,75,34,18,10,65
4,37,0.010253765620291233,0.7952755905511811,46,81,52,75,36,16,10,65
4,38,0.010230191051959991,0.8031496062992126,47,80,52,75,37,15,10,65
4,39,0.010042834095656872,0.8188976377952756,49,78,52,75,39,13,10,65
4,40,0.009709075093269348,0.8110236220472441,50,77,52,75,39,13,11,64
4,41,0.009419332258403301,0.8188976377952756,51,76,52,75,40,12,11,64
4,42,0.009152166545391083,0.8188976377952756,51,76,52,75,40,12,11,64
4,43,0.009199137799441814,0.8188976377952756,51,76,52,75,40,12,11,64
4,44,0.008739707060158253,0.8188976377952756,51,76,52,75,40,12,11,64
4,45,0.007754994090646505,0.8110236220472441,52,75,52,75,40,12,12,63
4,46,0.007321552373468876,0.8110236220472441,52,75,52,75,40,12,12,63
4,47,0.007565195672214031,0.8110236220472441,52,75,52,75,40,12,12,63
4,48,0.00700549827888608,0.8110236220472441,52,75,52,75,40,12,12,63
4,49,0.007319837808609009,0.8110236220472441,52,75,52,75,40,12,12,63
5,0,0.7003519535064697,0.4094488188976378,127,0,52,75,52,0,75,0
5,1,0.6812841296195984,0.5905511811023622,0,127,52,75,0,52,0,75
5,2,0.46128061413764954,0.5905511811023622,0,127,52,75,0,52,0,75
5,3,0.4130576550960541,0.5905511811023622,0,127,52,75,0,52,0,75
5,4,0.3466169238090515,0.5905511811023622,0,127,52,75,0,52,0,75
5,5,0.28157007694244385,0.5984251968503937,1,126,52,75,1,51,0,75
5,6,0.24332229793071747,0.6141732283464567,3,124,52,75,3,49,0,75
5,7,0.21205197274684906,0.6220472440944882,4,123,52,75,4,48,0,75
5,8,0.18204079568386078,0.6220472440944882,4,123,52,75,4,48,0,75
5,9,0.1528807282447815,0.6220472440944882,4,123,52,75,4,48,0,75
5,10,0.13442890346050262,0.6377952755905512,6,121,52,75,6,46,0,75
5,11,0.11664675176143646,0.6535433070866141,8,119,52,75,8,44,0,75
5,12,0.10095884650945663,0.6535433070866141,8,119,52,75,8,44,0,75
5,13,0.08674647659063339,0.6614173228346457,9,118,52,75,9,43,0,75
5,14,0.07446306943893433,0.6850393700787402,12,115,52,75,12,40,0,75
5,15,0.06661464273929596,0.7007874015748031,14,113,52,75,14,38,0,75
5,16,0.05801650881767273,0.7086614173228346,15,112,52,75,15,37,0,75
5,17,0.051346756517887115,0.7322834645669292,20,107,52,75,19,33,1,74
5,18,0.04518566280603409,0.7559055118110236,23,104,52,75,22,30,1,74
5,19,0.03923361375927925,0.7716535433070866,27,100,52,75,25,27,2,73
5,20,0.03494729846715927,0.7874015748031497,29,98,52,75,27,25,2,73
5,21,0.030498741194605827,0.7952755905511811,32,95,52,75,29,23,3,72
5,22,0.02725737728178501,0.7952755905511811,32,95,52,75,29,23,3,72
5,23,0.02525366097688675,0.8110236220472441,34,93,52,75,31,21,3,72
5,24,0.02221175841987133,0.7952755905511811,36,91,52,75,31,21,5,70
5,25,0.01916438154876232,0.7952755905511811,36,91,52,75,31,21,5,70
5,26,0.019466610625386238,0.8031496062992126,37,90,52,75,32,20,5,70
5,27,0.016428638249635696,0.8110236220472441,38,89,52,75,33,19,5,70
5,28,0.014870698563754559,0.8031496062992126,39,88,52,75,33,19,6,69
5,29,0.014177353121340275,0.8031496062992126,39,88,52,75,33,19,6,69
5,30,0.013095849193632603,0.8110236220472441,40,87,52,75,34,18,6,69
5,31,0.012230399996042252,0.8110236220472441,42,85,52,75,35,17,7,68
5,32,0.011489148251712322,0.8031496062992126,43,84,52,75,35,17,8,67
5,33,0.010419834405183792,0.8031496062992126,45,82,52,75,36,16,9,66
5,34,0.009797194972634315,0.8031496062992126,45,82,52,75,36,16,9,66
5,35,0.009204224683344364,0.8110236220472441,46,81,52,75,37,15,9,66
5,36,0.008987312205135822,0.8031496062992126,45,82,52,75,36,16,9,66
5,37,0.008103370666503906,0.8031496062992126,45,82,52,75,36,16,9,66
5,38,0.007914933376014233,0.8031496062992126,45,82,52,75,36,16,9,66
5,39,0.007594853173941374,0.8031496062992126,45,82,52,75,36,16,9,66
5,40,0.0070707225240767,0.8031496062992126,45,82,52,75,36,16,9,66
5,41,0.006948607973754406,0.8031496062992126,45,82,52,75,36,16,9,66
5,42,0.006241791881620884,0.8031496062992126,45,82,52,75,36,16,9,66
5,43,0.006507899146527052,0.8031496062992126,45,82,52,75,36,16,9,66
5,44,0.006112297065556049,0.8031496062992126,45,82,52,75,36,16,9,66
5,45,0.007587214931845665,0.8031496062992126,45,82,52,75,36,16,9,66
5,46,0.005438105668872595,0.7952755905511811,44,83,52,75,35,17,9,66
5,47,0.006030900403857231,0.8031496062992126,43,84,52,75,35,17,8,67
5,48,0.005416190251708031,0.8110236220472441,44,83,52,75,36,16,8,67
5,49,0.005542228929698467,0.8110236220472441,44,83,52,75,36,16,8,67
6,0,0.6970891952514648,0.4094488188976378,127,0,52,75,52,0,75,0
6,1,0.6284318566322327,0.5905511811023622,0,127,52,75,0,52,0,75
6,2,0.46692347526550293,0.5905511811023622,0,127,52,75,0,52,0,75
6,3,0.3963204324245453,0.5905511811023622,0,127,52,75,0,52,0,75
6,4,0.3108378052711487,0.6141732283464567,5,122,52,75,4,48,1,74
6,5,0.2622499167919159,0.6535433070866141,10,117,52,75,9,43,1,74
6,6,0.21851791441440582,0.7086614173228346,17,110,52,75,16,36,1,74
6,7,0.1796560138463974,0.7244094488188977,21,106,52,75,19,33,2,73
6,8,0.14828313887119293,0.7874015748031497,29,98,52,75,27,25,2,73
6,9,0.12581300735473633,0.8110236220472441,38,89,52,75,33,19,5,70
6,10,0.10673191398382187,0.8267716535433071,46,81,52,75,38,14,8,67
6,11,0.08980534970760345,0.8267716535433071,48,79,52,75,39,13,9,66
6,12,0.0775378942489624,0.8188976377952756,49,78,52,75,39,13,10,65
6,13,0.06543347239494324,0.8110236220472441,48,79,52,75,38,14,10,65
6,14,0.05551697686314583,0.8110236220472441,46,81,52,75,37,15,9,66
6,15,0.04867745190858841,0.8188976377952756,45,82,52,75,37,15,8,67
6,16,0.04244094341993332,0.8188976377952756,45,82,52,75,37,15,8,67
6,17,0.036048226058483124,0.8188976377952756,47,80,52,75,38,14,9,66
6,18,0.031172052025794983,0.8267716535433071,48,79,52,75,39,13,9,66
6,19,0.028641894459724426,0.8188976377952756,49,78,52,75,39,13,10,65
6,20,0.024263644590973854,0.8188976377952756,51,76,52,75,40,12,11,64
6,21,0.021710814908146858,0.7952755905511811,54,73,52,75,40,12,14,61
6,22,0.020311720669269562,0.8031496062992126,55,72,52,75,41,11,14,61
6,23,0.018850183114409447,0.8031496062992126,55,72,52,75,41,11,14,61
6,24,0.015878278762102127,0.7952755905511811,56,71,52,75,41,11,15,60
6,25,0.014402912929654121,0.7952755905511811,56,71,52,75,41,11,15,60
6,26,0.013590606860816479,0.7952755905511811,56,71,52,75,41,11,15,60
6,27,0.012869580648839474,0.8031496062992126,55,72,52,75,41,11,14,61
6,28,0.01170132216066122,0.7952755905511811,54,73,52,75,40,12,14,61
6,29,0.010844219475984573,0.7952755905511811,54,73,52,75,40,12,14,61
6,30,0.010663282126188278,0.7952755905511811,54,73,52,75,40,12,14,61
6,31,0.009343304671347141,0.7952755905511811,54,73,52,75,40,12,14,61
6,32,0.008971432223916054,0.7716535433070866,57,70,52,75,40,12,17,58
6,33,0.0082633625715971,0.7795275590551181,58,69,52,75,41,11,17,58
6,34,0.00787012092769146,0.7795275590551181,58,69,52,75,41,11,17,58
6,35,0.010080763138830662,0.7795275590551181,58,69,52,75,41,11,17,58
6,36,0.007941599935293198,0.7874015748031497,57,70,52,75,41,11,16,59
6,37,0.007622627075761557,0.7874015748031497,57,70,52,75,41,11,16,59
6,38,0.007276774849742651,0.7874015748031497,57,70,52,75,41,11,16,59
6,39,0.006458096671849489,0.7795275590551181,58,69,52,75,41,11,17,58
6,40,0.007578641641885042,0.7716535433070866,57,70,52,75,40,12,17,58
6,41,0.006531865801662207,0.7637795275590551,58,69,52,75,40,12,18,57
6,42,0.006070307921618223,0.7637795275590551,58,69,52,75,40,12,18,57
6,43,0.006140030920505524,0.7637795275590551,58,69,52,75,40,12,18,57
6,44,0.0062822261825203896,0.7716535433070866,57,70,52,75,40,12,17,58
6,45,0.005899105221033096,0.7716535433070866,57,70,52,75,40,12,17,58
6,46,0.005978446453809738,0.7795275590551181,58,69,52,75,41,11,17,58
6,47,0.005433748941868544,0.7795275590551181,58,69,52,75,41,11,17,58
6,48,0.005728439427912235,0.7795275590551181,58,69,52,75,41,11,17,58
6,49,0.006756802089512348,0.7795275590551181,58,69,52,75,41,11,17,58
7,0,0.7009572386741638,0.5905511811023622,0,127,52,75,0,52,0,75
7,1,0.6603874564170837,0.5905511811023622,0,127,52,75,0,52,0,75
7,2,0.44098255038261414,0.44881889763779526,122,5,52,75,52,0,70,5
7,3,0.393899142742157,0.4094488188976378,127,0,52,75,52,0,75,0
7,4,0.32733768224716187,0.4330708661417323,124,3,52,75,52,0,72,3
7,5,0.26542457938194275,0.48031496062992124,118,9,52,75,52,0,66,9
7,6,0.23269867897033691,0.5354330708661418,109,18,52,75,51,1,58,17
7,7,0.20066741108894348,0.5590551181102362,106,21,52,75,51,1,55,20
7,8,0.17093278467655182,0.5669291338582677,105,22,52,75,51,1,54,21
7,9,0.14583715796470642,0.5826771653543307,103,24,52,75,51,1,52,23
7,10,0.12701725959777832,0.6614173228346457,93,34,52,75,51,1,42,33
7,11,0.10824427753686905,0.7086614173228346,83,44,52,75,49,3,34,41
7,12,0.09451750665903091,0.7244094488188977,79,48,52,75,48,4,31,44
7,13,0.08070001751184464,0.7322834645669292,72,55,52,75,45,7,27,48
7,14,0.07103189826011658,0.7637795275590551,66,61,52,75,44,8,22,53
7,15,0.06078161671757698,0.7795275590551181,64,63,52,75,44,8,20,55
7,16,0.052439458668231964,0.7795275590551181,64,63,52,75,44,8,20,55
7,17,0.04661813750863075,0.7795275590551181,64,63,52,75,44,8,20,55
7,18,0.04206528514623642,0.7795275590551181,64,63,52,75,44,8,20,55
7,19,0.03664516285061836,0.7795275590551181,62,65,52,75,43,9,19,56
7,20,0.033023376017808914,0.7559055118110236,59,68,52,75,40,12,19,56
7,21,0.029740527272224426,0.7480314960629921,56,71,52,75,38,14,18,57
7,22,0.0249800868332386,0.7322834645669292,54,73,52,75,36,16,18,57
7,23,0.02350480481982231,0.7244094488188977,51,76,52,75,34,18,17,58
7,24,0.021578053012490273,0.7165354330708661,50,77,52,75,33,19,17,58
7,25,0.02051028050482273,0.7165354330708661,50,77,52,75,33,19,17,58
7,26,0.018842963501811028,0.7165354330708661,50,77,52,75,33,19,17,58
7,27,0.016734741628170013,0.7244094488188977,51,76,52,75,34,18,17,58
7,28,0.016062019392848015,0.7244094488188977,51,76,52,75,34,18,17,58
7,29,0.01381585281342268,0.7244094488188977,51,76,52,75,34,18,17,58
7,30,0.013292673975229263,0.7322834645669292,50,77,52,75,34,18,16,59
7,31,0.012377011589705944,0.7322834645669292,50,77,52,75,34,18,16,59
7,32,0.011631627567112446,0.7401574803149606,51,76,52,75,35,17,16,59
7,33,0.010593388229608536,0.7401574803149606,51,76,52,75,35,17,16,59
7,34,0.011071445420384407,0.7480314960629921,52,75,52,75,36,16,16,59
7,35,0.010234011337161064,0.7559055118110236,51,76,52,75,36,16,15,60
7,36,0.010140023194253445,0.7637795275590551,50,77,52,75,36,16,14,61
7,37,0.009904925711452961,0.7637795275590551,50,77,52,75,36,16,14,61
7,38,0.009041761979460716,0.7637795275590551,50,77,52,75,36,16,14,61
7,39,0.008530519902706146,0.7559055118110236,51,76,52,75,36,16,15,60
7,40,0.008754878304898739,0.7559055118110236,51,76,52,75,36,16,15,60
7,41,0.008344333618879318,0.7480314960629921,50,77,52,75,35,17,15,60
7,42,0.008223481476306915,0.7401574803149606,51,76,52,75,35,17,16,59
7,43,0.0071405465714633465,0.7401574803149606,51,76,52,75,35,17,16,59
7,44,0.007386267650872469,0.7401574803149606,51,76,52,75,35,17,16,59
7,45,0.008573577739298344,0.7401574803149606,51,76,52,75,35,17,16,59
7,46,0.007434496656060219,0.7322834645669292,52,75,52,75,35,17,17,58
7,47,0.007612483575940132,0.7401574803149606,51,76,52,75,35,17,16,59
7,48,0.0071439072489738464,0.7401574803149606,51,76,52,75,35,17,16,59
7,49,0.006373170297592878,0.7401574803149606,51,76,52,75,35,17,16,59
8,0,0.6964808106422424,0.5905511811023622,0,127,52,75,0,52,0,75
8,1,0.6671552658081055,0.5905511811023622,0,127,52,75,0,52,0,75
8,2,0.4030543565750122,0.7401574803149606,73,54,52,75,46,6,27,48
8,3,0.37791353464126587,0.7007874015748031,82,45,52,75,48,4,34,41
8,4,0.30332133173942566,0.7244094488188977,39,88,52,75,28,24,11,64
8,5,0.24175594747066498,0.6771653543307087,13,114,52,75,12,40,1,74
8,6,0.2140299379825592,0.6535433070866141,10,117,52,75,9,43,1,74
8,7,0.1902657449245453,0.6535433070866141,10,117,52,75,9,43,1,74
8,8,0.16345036029815674,0.6692913385826772,14,113,52,75,12,40,2,73
8,9,0.13607041537761688,0.6850393700787402,18,109,52,75,15,37,3,72
8,10,0.12097785621881485,0.6929133858267716,19,108,52,75,16,36,3,72
8,11,0.10543575137853622,0.6850393700787402,18,109,52,75,15,37,3,72
8,12,0.09196916222572327,0.6850393700787402,16,111,52,75,14,38,2,73
8,13,0.08000018447637558,0.6771653543307087,15,112,52,75,13,39,2,73
8,14,0.06935573369264603,0.6692913385826772,14,113,52,75,12,40,2,73
8,15,0.0621294341981411,0.6692913385826772,14,113,52,75,12,40,2,73
8,16,0.05485839396715164,0.6692913385826772,14,113,52,75,12,40,2,73
8,17,0.048061344772577286,0.6692913385826772,14,113,52,75,12,40,2,73
8,18,0.04207416623830795,0.6771653543307087,15,112,52,75,13,39,2,73
8,19,0.03706536814570427,0.6850393700787402,16,111,52,75,14,38,2,73
8,20,0.03324929252266884,0.7007874015748031,18,109,52,75,16,36,2,73
8,21,0.02944565936923027,0.7007874015748031,22,105,52,75,18,34,4,71
8,22,0.02632923051714897,0.7086614173228346,23,104,52,75,19,33,4,71
8,23,0.02413962595164776,0.7244094488188977,25,102,52,75,21,31,4,71
8,24,0.021464688703417778,0.7401574803149606,27,100,52,75,23,29,4,71
8,25,0.020242299884557724,0.7401574803149606,29,98,52,75,24,28,5,70
8,26,0.017944127321243286,0.7244094488188977,33,94,52,75,25,27,8,67
8,27,0.015994245186448097,0.7401574803149606,35,92,52,75,27,25,8,67
8,28,0.015189721249043941,0.7244094488188977,37,90,52,75,27,25,10,65
8,29,0.014249635860323906,0.7401574803149606,39,88,52,75,29,23,10,65
8,30,0.012857247143983841,0.7322834645669292,40,87,52,75,29,23,11,64
8,31,0.012231952510774136,0.7322834645669292,40,87,52,75,29,23,11,64
8,32,0.011298197321593761,0.7401574803149606,41,86,52,75,30,22,11,64
8,33,0.010952917858958244,0.7480314960629921,42,85,52,75,31,21,11,64
8,34,0.010549129918217659,0.7480314960629921,42,85,52,75,31,21,11,64
8,35,0.009512786753475666,0.7480314960629921,42,85,52,75,31,21,11,64
8,36,0.009499491192400455,0.7480314960629921,42,85,52,75,31,21,11,64
8,37,0.009223408065736294,0.7480314960629921,42,85,52,75,31,21,11,64
8,38,0.008071629330515862,0.7480314960629921,42,85,52,75,31,21,11,64
8,39,0.008463241159915924,0.7480314960629921,44,83,52,75,32,20,12,63
8,40,0.007675317116081715,0.7480314960629921,44,83,52,75,32,20,12,63
8,41,0.007547514047473669,0.7480314960629921,44,83,52,75,32,20,12,63
8,42,0.006889028009027243,0.7480314960629921,44,83,52,75,32,20,12,63
8,43,0.00687465351074934,0.7401574803149606,45,82,52,75,32,20,13,62
8,44,0.0068778726272284985,0.7401574803149606,45,82,52,75,32,20,13,62
8,45,0.0074548604898154736,0.7401574803149606,45,82,52,75,32,20,13,62
8,46,0.00645406823605299,0.7401574803149606,45,82,52,75,32,20,13,62
8,47,0.006025030743330717,0.7480314960629921,46,81,52,75,33,19,13,62
8,48,0.006526055280119181,0.7480314960629921,46,81,52,75,33,19,13,62
8,49,0.0066503118723630905,0.7480314960629921,46,81,52,75,33,19,13,62
9,0,0.7024142146110535,0.4094488188976378,127,0,52,75,52,0,75,0
9,1,0.669085681438446,0.4094488188976378,127,0,52,75,52,0,75,0
9,2,0.4616325795650482,0.4094488188976378,127,0,52,75,52,0,75,0
9,3,0.4105220139026642,0.49606299212598426,116,11,52,75,52,0,64,11
9,4,0.33547618985176086,0.5511811023622047,109,18,52,75,52,0,57,18
9,5,0.27250489592552185,0.5669291338582677,107,20,52,75,52,0,55,20
9,6,0.23667995631694794,0.5748031496062992,104,23,52,75,51,1,53,22
9,7,0.2003955990076065,0.6220472440944882,98,29,52,75,51,1,47,28
9,8,0.16931575536727905,0.6850393700787402,90,37,52,75,51,1,39,36
9,9,0.14342495799064636,0.7086614173228346,87,40,52,75,51,1,36,39
9,10,0.12479773908853531,0.7086614173228346,85,42,52,75,50,2,35,40
9,11,0.10670174658298492,0.6771653543307087,91,36,52,75,51,1,40,35
9,12,0.09075448662042618,0.6614173228346457,93,34,52,75,51,1,42,33
9,13,0.07872311770915985,0.6377952755905512,96,31,52,75,51,1,45,30
9,14,0.06840504705905914,0.6456692913385826,95,32,52,75,51,1,44,31
9,15,0.059140656143426895,0.6456692913385826,95,32,52,75,51,1,44,31
9,16,0.05079585686326027,0.6456692913385826,95,32,52,75,51,1,44,31
9,17,0.046273816376924515,0.6614173228346457,93,34,52,75,51,1,42,33
9,18,0.03906242176890373,0.6614173228346457,89,38,52,75,49,3,40,35
9,19,0.03496841341257095,0.6614173228346457,89,38,52,75,49,3,40,35
9,20,0.03159254789352417,0.6614173228346457,89,38,52,75,49,3,40,35
9,21,0.027996161952614784,0.6692913385826772,88,39,52,75,49,3,39,36
9,22,0.024883754551410675,0.6692913385826772,88,39,52,75,49,3,39,36
9,23,0.021980470046401024,0.6692913385826772,86,41,52,75,48,4,38,37
9,24,0.020038869231939316,0.6850393700787402,84,43,52,75,48,4,36,39
9,25,0.018534082919359207,0.7086614173228346,81,46,52,75,48,4,33,42
9,26,0.01675797440111637,0.7086614173228346,81,46,52,75,48,4,33,42
9,27,0.01618470810353756,0.7165354330708661,80,47,52,75,48,4,32,43
9,28,0.015163922682404518,0.7480314960629921,76,51,52,75,48,4,28,47
9,29,0.013758644461631775,0.7559055118110236,75,52,52,75,48,4,27,48
9,30,0.012251208536326885,0.7559055118110236,73,54,52,75,47,5,26,49
9,31,0.01276225782930851,0.7480314960629921,72,55,52,75,46,6,26,49
9,32,0.011092240922152996,0.7480314960629921,68,59,52,75,44,8,24,51
9,33,0.009951567277312279,0.7559055118110236,67,60,52,75,44,8,23,52
9,34,0.010876355692744255,0.7559055118110236,67,60,52,75,44,8,23,52
9,35,0.00988744292408228,0.7559055118110236,67,60,52,75,44,8,23,52
9,36,0.007997835986316204,0.7716535433070866,65,62,52,75,44,8,21,54
9,37,0.008079017512500286,0.7716535433070866,65,62,52,75,44,8,21,54
9,38,0.008764190599322319,0.7716535433070866,65,62,52,75,44,8,21,54
9,39,0.0074174664914608,0.7716535433070866,65,62,52,75,44,8,21,54
9,40,0.007542071398347616,0.7716535433070866,65,62,52,75,44,8,21,54
9,41,0.006938552483916283,0.7716535433070866,65,62,52,75,44,8,21,54
9,42,0.006852187681943178,0.7795275590551181,64,63,52,75,44,8,20,55
9,43,0.0070977662689983845,0.7716535433070866,63,64,52,75,43,9,20,55
9,44,0.006545822136104107,0.7716535433070866,63,64,52,75,43,9,20,55
9,45,0.006099336314946413,0.7795275590551181,62,65,52,75,43,9,19,56
9,46,0.006014070473611355,0.7795275590551181,62,65,52,75,43,9,19,56
9,47,0.005743617191910744,0.7874015748031497,61,66,52,75,43,9,18,57
9,48,0.005466420669108629,0.7952755905511811,60,67,52,75,43,9,17,58
9,49,0.005745966453105211,0.7952755905511811,60,67,52,75,43,9,17,58
10,0,0.6974446773529053,0.5905511811023622,0,127,52,75,0,52,0,75
10,1,0.6702970862388611,0.4094488188976378,127,0,52,75,52,0,75,0
10,2,0.43701478838920593,0.4094488188976378,127,0,52,75,52,0,75,0
10,3,0.37880608439445496,0.4094488188976378,127,0,52,75,52,0,75,0
10,4,0.29850995540618896,0.4094488188976378,127,0,52,75,52,0,75,0
10,5,0.24781441688537598,0.4094488188976378,127,0,52,75,52,0,75,0
10,6,0.2137908935546875,0.4094488188976378,127,0,52,75,52,0,75,0
10,7,0.18123145401477814,0.4094488188976378,127,0,52,75,52,0,75,0
10,8,0.15407279133796692,0.4094488188976378,127,0,52,75,52,0,75,0
10,9,0.13273273408412933,0.4094488188976378,127,0,52,75,52,0,75,0
10,10,0.11655968427658081,0.4094488188976378,127,0,52,75,52,0,75,0
10,11,0.1017284244298935,0.4330708661417323,124,3,52,75,52,0,72,3
10,12,0.08602806180715561,0.48031496062992124,118,9,52,75,52,0,66,9
10,13,0.07662162184715271,0.5275590551181102,112,15,52,75,52,0,60,15
10,14,0.06749728322029114,0.5984251968503937,103,24,52,75,52,0,51,24
10,15,0.05955204367637634,0.6614173228346457,95,32,52,75,52,0,43,32
10,16,0.0540069080889225,0.6929133858267716,89,38,52,75,51,1,38,37
10,17,0.04631265252828598,0.7480314960629921,80,47,52,75,50,2,30,45
10,18,0.0414874367415905,0.7716535433070866,77,50,52,75,50,2,27,48
10,19,0.035479310899972916,0.7795275590551181,74,53,52,75,49,3,25,50
10,20,0.03197944909334183,0.8031496062992126,71,56,52,75,49,3,22,53
10,21,0.029493356123566628,0.84251968503937,66,61,52,75,49,3,17,58
10,22,0.028482157737016678,0.84251968503937,64,63,52,75,48,4,16,59
10,23,0.02369839698076248,0.8503937007874016,61,66,52,75,47,5,14,61
10,24,0.02152618207037449,0.8503937007874016,61,66,52,75,47,5,14,61
10,25,0.01949264295399189,0.8661417322834646,59,68,52,75,47,5,12,63
10,26,0.017850607633590698,0.8661417322834646,59,68,52,75,47,5,12,63
10,27,0.017257163301110268,0.8582677165354331,58,69,52,75,46,6,12,63
10,28,0.015322064980864525,0.8582677165354331,58,69,52,75,46,6,12,63
10,29,0.014430147595703602,0.8582677165354331,58,69,52,75,46,6,12,63
10,30,0.014097370207309723,0.8503937007874016,59,68,52,75,46,6,13,62
10,31,0.012944705784320831,0.8503937007874016,59,68,52,75,46,6,13,62
10,32,0.011861409060657024,0.8503937007874016,59,68,52,75,46,6,13,62
10,33,0.010716767981648445,0.8503937007874016,59,68,52,75,46,6,13,62
10,34,0.011044410057365894,0.8503937007874016,59,68,52,75,46,6,13,62
10,35,0.0106350751593709,0.8503937007874016,59,68,52,75,46,6,13,62
10,36,0.011556622572243214,0.8503937007874016,59,68,52,75,46,6,13,62
10,37,0.010307349264621735,0.8503937007874016,59,68,52,75,46,6,13,62
10,38,0.009098623879253864,0.8503937007874016,59,68,52,75,46,6,13,62
10,39,0.008902245201170444,0.8503937007874016,59,68,52,75,46,6,13,62
10,40,0.009254105389118195,0.8503937007874016,59,68,52,75,46,6,13,62
10,41,0.008746478706598282,0.8503937007874016,59,68,52,75,46,6,13,62
10,42,0.00924112368375063,0.8503937007874016,59,68,52,75,46,6,13,62
10,43,0.008564788848161697,0.8503937007874016,59,68,52,75,46,6,13,62
10,44,0.00778943533077836,0.8503937007874016,59,68,52,75,46,6,13,62
10,45,0.00775144062936306,0.8503937007874016,59,68,52,75,46,6,13,62
10,46,0.007056137081235647,0.8503937007874016,59,68,52,75,46,6,13,62
10,47,0.007337153423577547,0.84251968503937,60,67,52,75,46,6,14,61
10,48,0.006630283314734697,0.84251968503937,60,67,52,75,46,6,14,61
10,49,0.007375502027571201,0.84251968503937,60,67,52,75,46,6,14,61
11,0,0.7733529806137085,0.4094488188976378,127,0,52,75,52,0,75,0
11,1,0.6416942477226257,0.5905511811023622,0,127,52,75,0,52,0,75
11,2,0.5337271094322205,0.5905511811023622,0,127,52,75,0,52,0,75
11,3,0.45192405581474304,0.5905511811023622,0,127,52,75,0,52,0,75
11,4,0.3781889081001282,0.5905511811023622,0,127,52,75,0,52,0,75
11,5,0.3145429491996765,0.5905511811023622,0,127,52,75,0,52,0,75
11,6,0.2652547359466553,0.5905511811023622,0,127,52,75,0,52,0,75
11,7,0.22430765628814697,0.5905511811023622,0,127,52,75,0,52,0,75
11,8,0.1905212551355362,0.5905511811023622,0,127,52,75,0,52,0,75
11,9,0.1628246158361435,0.5905511811023622,0,127,52,75,0,52,0,75
11,10,0.13888861238956451,0.5905511811023622,0,127,52,75,0,52,0,75
11,11,0.11935526877641678,0.5984251968503937,1,126,52,75,1,51,0,75
11,12,0.10034265369176865,0.6299212598425197,5,122,52,75,5,47,0,75
11,13,0.0890982523560524,0.6456692913385826,7,120,52,75,7,45,0,75
11,14,0.07653239369392395,0.6456692913385826,9,118,52,75,8,44,1,74
11,15,0.06562580168247223,0.6535433070866141,12,115,52,75,10,42,2,73
11,16,0.05840315669775009,0.6929133858267716,17,110,52,75,15,37,2,73
11,17,0.05110830441117287,0.7007874015748031,20,107,52,75,17,35,3,72
11,18,0.045547813177108765,0.7007874015748031,22,105,52,75,18,34,4,71
11,19,0.03943122923374176,0.7165354330708661,24,103,52,75,20,32,4,71
11,20,0.03622092306613922,0.7401574803149606,27,100,52,75,23,29,4,71
11,21,0.030782578513026237,0.7637795275590551,30,97,52,75,26,26,4,71
11,22,0.027203945443034172,0.7716535433070866,35,92,52,75,29,23,6,69
11,23,0.02480291947722435,0.7874015748031497,37,90,52,75,31,21,6,69
11,24,0.022346094250679016,0.7952755905511811,38,89,52,75,32,20,6,69
11,25,0.02014615759253502,0.8188976377952756,41,86,52,75,35,17,6,69
11,26,0.018549397587776184,0.8267716535433071,42,85,52,75,36,16,6,69
11,27,0.01798251084983349,0.8267716535433071,42,85,52,75,36,16,6,69
11,28,0.015684273093938828,0.8188976377952756,43,84,52,75,36,16,7,68
11,29,0.015683317556977272,0.8267716535433071,44,83,52,75,37,15,7,68
11,30,0.013083512894809246,0.8188976377952756,45,82,52,75,37,15,8,67
11,31,0.012113725766539574,0.8188976377952756,45,82,52,75,37,15,8,67
11,32,0.0131978215649724,0.8188976377952756,45,82,52,75,37,15,8,67
11,33,0.013276217505335808,0.8188976377952756,45,82,52,75,37,15,8,67
11,34,0.011897780932486057,0.8110236220472441,46,81,52,75,37,15,9,66
11,35,0.009496871381998062,0.8031496062992126,47,80,52,75,37,15,10,65
11,36,0.009424540214240551,0.8110236220472441,48,79,52,75,38,14,10,65
11,37,0.00939936563372612,0.8110236220472441,48,79,52,75,38,14,10,65
11,38,0.009338130243122578,0.8110236220472441,48,79,52,75,38,14,10,65
11,39,0.008513159118592739,0.8031496062992126,49,78,52,75,38,14,11,64
11,40,0.010144862346351147,0.8031496062992126,49,78,52,75,38,14,11,64
11,41,0.008211329579353333,0.8031496062992126,49,78,52,75,38,14,11,64
11,42,0.008025087416172028,0.8031496062992126,49,78,52,75,38,14,11,64
11,43,0.007685863878577948,0.8031496062992126,49,78,52,75,38,14,11,64
11,44,0.008086969144642353,0.8031496062992126,49,78,52,75,38,14,11,64
11,45,0.006970354821532965,0.8031496062992126,49,78,52,75,38,14,11,64
11,46,0.008240428753197193,0.8110236220472441,48,79,52,75,38,14,10,65
11,47,0.006350835785269737,0.8110236220472441,48,79,52,75,38,14,10,65
11,48,0.007229737006127834,0.8110236220472441,48,79,52,75,38,14,10,65
11,49,0.00795905850827694,0.8110236220472441,48,79,52,75,38,14,10,65
12,0,0.6908184885978699,0.5905511811023622,0,127,52,75,0,52,0,75
12,1,0.577811598777771,0.5905511811023622,0,127,52,75,0,52,0,75
12,2,0.4200412333011627,0.5905511811023622,0,127,52,75,0,52,0,75
12,3,0.3394775986671448,0.5905511811023622,0,127,52,75,0,52,0,75
12,4,0.25925323367118835,0.6614173228346457,13,114,52,75,11,41,2,73
12,5,0.22115224599838257,0.7952755905511811,44,83,52,75,35,17,9,66
12,6,0.1825089156627655,0.7795275590551181,50,77,52,75,37,15,13,62
12,7,0.1502760350704193,0.7795275590551181,52,75,52,75,38,14,14,61
12,8,0.12965360283851624,0.7952755905511811,52,75,52,75,39,13,13,62
12,9,0.11000687628984451,0.7795275590551181,56,71,52,75,40,12,16,59
12,10,0.09197790175676346,0.8031496062992126,59,68,52,75,43,9,16,59
12,11,0.08013159781694412,0.7952755905511811,60,67,52,75,43,9,17,58
12,12,0.06875523924827576,0.7952755905511811,60,67,52,75,43,9,17,58
12,13,0.06016650050878525,0.7874015748031497,59,68,52,75,42,10,17,58
12,14,0.051082633435726166,0.7952755905511811,56,71,52,75,41,11,15,60
12,15,0.04638564959168434,0.8110236220472441,54,73,52,75,41,11,13,62
12,16,0.039103373885154724,0.8110236220472441,54,73,52,75,41,11,13,62
12,17,0.034353114664554596,0.8110236220472441,54,73,52,75,41,11,13,62
12,18,0.03210510313510895,0.8110236220472441,54,73,52,75,41,11,13,62
12,19,0.029038358479738235,0.8110236220472441,54,73,52,75,41,11,13,62
12,20,0.02511114813387394,0.7952755905511811,54,73,52,75,40,12,14,61
12,21,0.022552523761987686,0.7952755905511811,54,73,52,75,40,12,14,61
12,22,0.019748233258724213,0.7952755905511811,54,73,52,75,40,12,14,61
12,23,0.01858888752758503,0.7952755905511811,54,73,52,75,40,12,14,61
12,24,0.016553496941924095,0.7795275590551181,56,71,52,75,40,12,16,59
12,25,0.016126619651913643,0.7874015748031497,55,72,52,75,40,12,15,60
12,26,0.01427291240543127,0.7952755905511811,54,73,52,75,40,12,14,61
12,27,0.014329145662486553,0.7952755905511811,54,73,52,75,40,12,14,61
12,28,0.012231961823999882,0.7952755905511811,54,73,52,75,40,12,14,61
12,29,0.011594796553254128,0.8031496062992126,53,74,52,75,40,12,13,62
12,30,0.010713690891861916,0.8031496062992126,53,74,52,75,40,12,13,62
12,31,0.009947491809725761,0.8031496062992126,53,74,52,75,40,12,13,62
12,32,0.010426146909594536,0.8031496062992126,53,74,52,75,40,12,13,62
12,33,0.009497213177382946,0.8110236220472441,52,75,52,75,40,12,12,63
12,34,0.009274912998080254,0.8110236220472441,52,75,52,75,40,12,12,63
12,35,0.008989502675831318,0.8110236220472441,52,75,52,75,40,12,12,63
12,36,0.008718798868358135,0.8110236220472441,52,75,52,75,40,12,12,63
12,37,0.00772735383361578,0.8031496062992126,53,74,52,75,40,12,13,62
12,38,0.008634837344288826,0.7874015748031497,53,74,52,75,39,13,14,61
12,39,0.007143167778849602,0.7952755905511811,52,75,52,75,39,13,13,62
12,40,0.008034233935177326,0.7952755905511811,52,75,52,75,39,13,13,62
12,41,0.006815820466727018,0.7952755905511811,52,75,52,75,39,13,13,62
12,42,0.006767292972654104,0.7874015748031497,51,76,52,75,38,14,13,62
12,43,0.006425168830901384,0.7874015748031497,51,76,52,75,38,14,13,62
12,44,0.006854732520878315,0.7874015748031497,51,76,52,75,38,14,13,62
12,45,0.006610263604670763,0.7874015748031497,51,76,52,75,38,14,13,62
12,46,0.006374755874276161,0.7874015748031497,51,76,52,75,38,14,13,62
12,47,0.005889266729354858,0.7795275590551181,52,75,52,75,38,14,14,61
12,48,0.00662272097542882,0.7716535433070866,53,74,52,75,38,14,15,60
12,49,0.00591277563944459,0.7716535433070866,53,74,52,75,38,14,15,60
13,0,0.7027115821838379,0.41732283464566927,126,1,52,75,52,0,74,1
13,1,0.7208847403526306,0.4094488188976378,127,0,52,75,52,0,75,0
13,2,0.4545951783657074,0.4094488188976378,127,0,52,75,52,0,75,0
13,3,0.40758275985717773,0.4094488188976378,127,0,52,75,52,0,75,0
13,4,0.3430618643760681,0.4094488188976378,127,0,52,75,52,0,75,0
13,5,0.2748325765132904,0.4251968503937008,125,2,52,75,52,0,73,2
13,6,0.24126039445400238,0.49606299212598426,116,11,52,75,52,0,64,11
13,7,0.21552728116512299,0.5590551181102362,108,19,52,75,52,0,56,19
13,8,0.18538884818553925,0.5748031496062992,106,21,52,75,52,0,54,21
13,9,0.1598755270242691,0.5826771653543307,105,22,52,75,52,0,53,22
13,10,0.1419094055891037,0.6220472440944882,98,29,52,75,51,1,47,28
13,11,0.1252671480178833,0.6692913385826772,92,35,52,75,51,1,41,34
13,12,0.10857395082712173,0.7165354330708661,84,43,52,75,50,2,34,41
13,13,0.09592222422361374,0.7244094488188977,81,46,52,75,49,3,32,43
13,14,0.08470961451530457,0.7244094488188977,79,48,52,75,48,4,31,44
13,15,0.07423549145460129,0.7401574803149606,75,52,52,75,47,5,28,47
13,16,0.06738121807575226,0.7401574803149606,71,56,52,75,45,7,26,49
13,17,0.059096451848745346,0.7401574803149606,71,56,52,75,45,7,26,49
13,18,0.052717000246047974,0.7480314960629921,70,57,52,75,45,7,25,50
13,19,0.04745805263519287,0.7637795275590551,68,59,52,75,45,7,23,52
13,20,0.041860707104206085,0.7637795275590551,66,61,52,75,44,8,22,53
13,21,0.0389273501932621,0.7874015748031497,61,66,52,75,43,9,18,57
13,22,0.033986493945121765,0.8031496062992126,59,68,52,75,43,9,16,59
13,23,0.03164295107126236,0.7952755905511811,58,69,52,75,42,10,16,59
13,24,0.027934575453400612,0.8031496062992126,55,72,52,75,41,11,14,61
13,25,0.025862345471978188,0.8031496062992126,55,72,52,75,41,11,14,61
13,26,0.02397175319492817,0.7952755905511811,52,75,52,75,39,13,13,62
13,27,0.022572696208953857,0.8031496062992126,51,76,52,75,39,13,12,63
13,28,0.0202605202794075,0.7952755905511811,50,77,52,75,38,14,12,63
13,29,0.0192253477871418,0.7795275590551181,48,79,52,75,36,16,12,63
13,30,0.017438611015677452,0.7795275590551181,48,79,52,75,36,16,12,63
13,31,0.015390492044389248,0.7795275590551181,48,79,52,75,36,16,12,63
13,32,0.014992667362093925,0.7795275590551181,48,79,52,75,36,16,12,63
13,33,0.013442636467516422,0.7795275590551181,48,79,52,75,36,16,12,63
13,34,0.01312476210296154,0.7795275590551181,48,79,52,75,36,16,12,63
13,35,0.012794909067451954,0.7874015748031497,49,78,52,75,37,15,12,63
13,36,0.012192348018288612,0.7874015748031497,49,78,52,75,37,15,12,63
13,37,0.011913491412997246,0.7874015748031497,49,78,52,75,37,15,12,63
13,38,0.010676857084035873,0.7874015748031497,49,78,52,75,37,15,12,63
13,39,0.010350765660405159,0.7874015748031497,49,78,52,75,37,15,12,63
13,40,0.009440761059522629,0.7874015748031497,49,78,52,75,37,15,12,63
13,41,0.009158912114799023,0.7874015748031497,49,78,52,75,37,15,12,63
13,42,0.008715836331248283,0.7874015748031497,49,78,52,75,37,15,12,63
13,43,0.008244582451879978,0.7874015748031497,49,78,52,75,37,15,12,63
13,44,0.008605738170444965,0.7874015748031497,49,78,52,75,37,15,12,63
13,45,0.007612860761582851,0.7874015748031497,49,78,52,75,37,15,12,63
13,46,0.007869768887758255,0.7874015748031497,49,78,52,75,37,15,12,63
13,47,0.0074229310266673565,0.7874015748031497,49,78,52,75,37,15,12,63
13,48,0.007936901412904263,0.7874015748031497,49,78,52,75,37,15,12,63
13,49,0.00857924111187458,0.7874015748031497,49,78,52,75,37,15,12,63
14,0,0.7009111642837524,0.5826771653543307,0,127,53,74,0,53,0,74
14,1,0.6487395167350769,0.41732283464566927,127,0,53,74,53,0,74,0
14,2,0.46434861421585083,0.41732283464566927,127,0,53,74,53,0,74,0
14,3,0.389475017786026,0.4330708661417323,125,2,53,74,53,0,72,2
14,4,0.2980685234069824,0.7086614173228346,82,45,53,74,49,4,33,41
14,5,0.2492348700761795,0.7874015748031497,54,73,53,74,40,13,14,60
14,6,0.2107839733362198,0.7874015748031497,56,71,53,74,41,12,15,59
14,7,0.17496727406978607,0.7952755905511811,63,64,53,74,45,8,18,56
14,8,0.15089121460914612,0.7874015748031497,64,63,53,74,45,8,19,55
14,9,0.13103382289409637,0.7795275590551181,57,70,53,74,41,12,16,58
14,10,0.11102775484323502,0.8188976377952756,48,79,53,74,39,14,9,65
14,11,0.09503751248121262,0.8188976377952756,46,81,53,74,38,15,8,66
14,12,0.08140070736408234,0.8267716535433071,47,80,53,74,39,14,8,66
14,13,0.07377613335847855,0.8267716535433071,47,80,53,74,39,14,8,66
14,14,0.06256379187107086,0.8267716535433071,49,78,53,74,40,13,9,65
14,15,0.05515371263027191,0.8188976377952756,50,77,53,74,40,13,10,64
14,16,0.04876360669732094,0.8110236220472441,51,76,53,74,40,13,11,63
14,17,0.043196965008974075,0.8110236220472441,51,76,53,74,40,13,11,63
14,18,0.037699177861213684,0.8188976377952756,50,77,53,74,40,13,10,64
14,19,0.0333263985812664,0.8346456692913385,48,79,53,74,40,13,8,66
14,20,0.030628608539700508,0.84251968503937,47,80,53,74,40,13,7,67
14,21,0.025686336681246758,0.84251968503937,47,80,53,74,40,13,7,67
14,22,0.02406032755970955,0.84251968503937,47,80,53,74,40,13,7,67
14,23,0.021572092548012733,0.84251968503937,47,80,53,74,40,13,7,67
14,24,0.019669415429234505,0.84251968503937,47,80,53,74,40,13,7,67
14,25,0.018647655844688416,0.84251968503937,47,80,53,74,40,13,7,67
14,26,0.01620975323021412,0.84251968503937,47,80,53,74,40,13,7,67
14,27,0.015558148734271526,0.84251968503937,47,80,53,74,40,13,7,67
14,28,0.013369552791118622,0.84251968503937,47,80,53,74,40,13,7,67
14,29,0.011967452242970467,0.84251968503937,47,80,53,74,40,13,7,67
14,30,0.011563987471163273,0.84251968503937,47,80,53,74,40,13,7,67
14,31,0.01107226125895977,0.84251968503937,47,80,53,74,40,13,7,67
14,32,0.010468163527548313,0.8267716535433071,47,80,53,74,39,14,8,66
14,33,0.009474187158048153,0.8188976377952756,46,81,53,74,38,15,8,66
14,34,0.00987695250660181,0.8188976377952756,46,81,53,74,38,15,8,66
14,35,0.008762306533753872,0.8188976377952756,46,81,53,74,38,15,8,66
14,36,0.00872567668557167,0.8110236220472441,45,82,53,74,37,16,8,66
14,37,0.009659909643232822,0.8110236220472441,45,82,53,74,37,16,8,66
14,38,0.008915812708437443,0.8188976377952756,46,81,53,74,38,15,8,66
14,39,0.009789557196199894,0.8188976377952756,46,81,53,74,38,15,8,66
14,40,0.007499360479414463,0.8188976377952756,46,81,53,74,38,15,8,66
14,41,0.006856898777186871,0.8188976377952756,46,81,53,74,38,15,8,66
14,42,0.006882504094392061,0.8188976377952756,46,81,53,74,38,15,8,66
14,43,0.0065071783028542995,0.8188976377952756,46,81,53,74,38,15,8,66
14,44,0.0064812153577804565,0.8188976377952756,46,81,53,74,38,15,8,66
14,45,0.006128285545855761,0.8188976377952756,46,81,53,74,38,15,8,66
14,46,0.006357269361615181,0.8346456692913385,48,79,53,74,40,13,8,66
14,47,0.005739768501371145,0.8346456692913385,48,79,53,74,40,13,8,66
14,48,0.0061666215769946575,0.8267716535433071,49,78,53,74,40,13,9,65
14,49,0.005907989107072353,0.8188976377952756,50,77,53,74,40,13,10,64
15,0,0.7143814563751221,0.41732283464566927,127,0,53,74,53,0,74,0
15,1,0.667751669883728,0.41732283464566927,127,0,53,74,53,0,74,0
15,2,0.4690916836261749,0.7716535433070866,30,97,53,74,27,26,3,71
15,3,0.39093539118766785,0.5826771653543307,0,127,53,74,0,53,0,74
15,4,0.3312027156352997,0.6062992125984252,3,124,53,74,3,50,0,74
15,5,0.26795694231987,0.6377952755905512,7,120,53,74,7,46,0,74
15,6,0.22747328877449036,0.6692913385826772,11,116,53,74,11,42,0,74
15,7,0.19881559908390045,0.6692913385826772,11,116,53,74,11,42,0,74
15,8,0.17128311097621918,0.6692913385826772,11,116,53,74,11,42,0,74
15,9,0.14396053552627563,0.6692913385826772,11,116,53,74,11,42,0,74
15,10,0.12370718270540237,0.6614173228346457,10,117,53,74,10,43,0,74
15,11,0.10916203260421753,0.7007874015748031,15,112,53,74,15,38,0,74
15,12,0.09289311617612839,0.7322834645669292,21,106,53,74,20,33,1,73
15,13,0.0796046108007431,0.7559055118110236,26,101,53,74,24,29,2,72
15,14,0.06903161853551865,0.7716535433070866,32,95,53,74,28,25,4,70
15,15,0.06171151623129845,0.8031496062992126,36,91,53,74,32,21,4,70
15,16,0.05391087755560875,0.8110236220472441,39,88,53,74,34,19,5,69
15,17,0.04666993021965027,0.8188976377952756,40,87,53,74,35,18,5,69
15,18,0.03959488868713379,0.8267716535433071,41,86,53,74,36,17,5,69
15,19,0.03574269637465477,0.8110236220472441,41,86,53,74,35,18,6,68
15,20,0.03224607929587364,0.8110236220472441,41,86,53,74,35,18,6,68
15,21,0.02729705348610878,0.8346456692913385,44,83,53,74,38,15,6,68
15,22,0.02536211535334587,0.8346456692913385,44,83,53,74,38,15,6,68
15,23,0.02236703597009182,0.8346456692913385,46,81,53,74,39,14,7,67
15,24,0.020548980683088303,0.8346456692913385,46,81,53,74,39,14,7,67
15,25,0.019453566521406174,0.84251968503937,47,80,53,74,40,13,7,67
15,26,0.017439328134059906,0.84251968503937,49,78,53,74,41,12,8,66
15,27,0.016934329643845558,0.8503937007874016,50,77,53,74,42,11,8,66
15,28,0.015363364480435848,0.8503937007874016,50,77,53,74,42,11,8,66
15,29,0.013604078441858292,0.8503937007874016,50,77,53,74,42,11,8,66
15,30,0.01230285968631506,0.8582677165354331,51,76,53,74,43,10,8,66
15,31,0.0128122977912426,0.8503937007874016,52,75,53,74,43,10,9,65
15,32,0.010814509354531765,0.8503937007874016,52,75,53,74,43,10,9,65
15,33,0.010414086282253265,0.8503937007874016,52,75,53,74,43,10,9,65
15,34,0.011114407330751419,0.8503937007874016,52,75,53,74,43,10,9,65
15,35,0.010417413897812366,0.8503937007874016,52,75,53,74,43,10,9,65
15,36,0.00969520304352045,0.8503937007874016,52,75,53,74,43,10,9,65
15,37,0.008406043983995914,0.8503937007874016,52,75,53,74,43,10,9,65
15,38,0.009059208445250988,0.8503937007874016,52,75,53,74,43,10,9,65
15,39,0.007875360548496246,0.8503937007874016,52,75,53,74,43,10,9,65
15,40,0.00807991810142994,0.8503937007874016,52,75,53,74,43,10,9,65
15,41,0.007202151231467724,0.8503937007874016,52,75,53,74,43,10,9,65
15,42,0.0071993013843894005,0.8582677165354331,49,78,53,74,42,11,7,67
15,43,0.007759688422083855,0.8582677165354331,49,78,53,74,42,11,7,67
15,44,0.0062128775753080845,0.8582677165354331,49,78,53,74,42,11,7,67
15,45,0.007159803062677383,0.8582677165354331,49,78,53,74,42,11,7,67
15,46,0.005929707549512386,0.8582677165354331,49,78,53,74,42,11,7,67
15,47,0.006003241986036301,0.8582677165354331,49,78,53,74,42,11,7,67
15,48,0.00758450897410512,0.8582677165354331,49,78,53,74,42,11,7,67
15,49,0.005435035564005375,0.8582677165354331,49,78,53,74,42,11,7,67
